//MAP CONVERTED BY dmm2tgm.py THIS HEADER COMMENT PREVENTS RECONVERSION, DO NOT REMOVE
"a" = (
/turf/closed/wall/mineral/titanium,
/area/virtual_domain/safehouse)
"c" = (
/obj/machinery/light/small/directional/south,
/obj/effect/turf_decal/stripes/line{
	dir = 10
	},
/obj/effect/landmark/bitrunning/hololadder_spawn,
/turf/open/floor/iron,
/area/virtual_domain/safehouse)
"i" = (
/obj/effect/spawner/structure/window/reinforced/shuttle,
/turf/open/floor/plating,
/area/virtual_domain/safehouse)
"j" = (
/obj/effect/turf_decal/stripes/end{
	dir = 1
	},
/obj/effect/turf_decal/sand/volcanic,
/obj/effect/landmark/bitrunning/hololadder_spawn,
/turf/open/floor/iron,
/area/virtual_domain/safehouse)
"k" = (
/obj/machinery/power/shuttle_engine/propulsion/burst{
	dir = 8
	},
/obj/structure/window/reinforced/spawner/directional/east,
/obj/effect/turf_decal/stripes/line{
	dir = 8
	},
/turf/open/floor/plating/airless,
/area/virtual_domain/safehouse)
"m" = (
/obj/effect/turf_decal/stripes/end,
/obj/effect/decal/cleanable/dirt,
/obj/effect/landmark/bitrunning/hololadder_spawn,
/turf/open/floor/iron,
/area/virtual_domain/safehouse)
"n" = (
/obj/effect/turf_decal/tile/neutral/fourcorners,
/turf/open/floor/iron,
/area/virtual_domain/safehouse)
"p" = (
/obj/effect/turf_decal/tile/neutral/fourcorners,
/obj/effect/decal/cleanable/dirt,
/turf/open/floor/iron,
/area/virtual_domain/safehouse)
"q" = (
/obj/effect/turf_decal/tile/neutral/half/contrasted,
/obj/effect/turf_decal/stripes/line{
	dir = 1
	},
/obj/machinery/light/small/directional/north,
/obj/effect/decal/cleanable/dirt,
/obj/effect/landmark/bitrunning/hololadder_spawn,
/turf/open/floor/iron,
/area/virtual_domain/safehouse)
"r" = (
/obj/effect/turf_decal/stripes/line{
	dir = 1
	},
/obj/machinery/door/airlock/shuttle/glass,
/obj/effect/turf_decal/stripes/line,
/obj/effect/turf_decal/sand/volcanic,
/obj/structure/fans/tiny,
/turf/open/floor/iron/white,
/area/virtual_domain/safehouse)
"s" = (
/obj/effect/turf_decal/tile/neutral/half/contrasted{
	dir = 1
	},
/obj/effect/turf_decal/stripes/line,
/obj/effect/landmark/bitrunning/hololadder_spawn,
/turf/open/floor/iron,
/area/virtual_domain/safehouse)
"v" = (
/obj/effect/turf_decal/stripes/line,
/obj/effect/landmark/bitrunning/hololadder_spawn,
/turf/open/floor/iron,
/area/virtual_domain/safehouse)
"z" = (
/obj/effect/turf_decal/tile/neutral/fourcorners,
/obj/effect/turf_decal/stripes/line,
/turf/open/floor/iron,
/area/virtual_domain/safehouse)
"A" = (
/obj/effect/turf_decal/tile/neutral/fourcorners,
/obj/effect/turf_decal/stripes/line{
	dir = 4
	},
/obj/effect/landmark/bitrunning/hololadder_spawn,
/turf/open/floor/iron,
/area/virtual_domain/safehouse)
"D" = (
/obj/effect/turf_decal/stripes/line{
	dir = 1
	},
/turf/open/floor/iron,
/area/virtual_domain/safehouse)
"F" = (
/obj/effect/turf_decal/tile/neutral,
/obj/effect/turf_decal/stripes/line{
	dir = 5
	},
/obj/effect/decal/cleanable/dirt,
/obj/effect/landmark/bitrunning/hololadder_spawn,
/turf/open/floor/iron,
/area/virtual_domain/safehouse)
"G" = (
/obj/effect/turf_decal/tile/neutral/fourcorners,
/obj/effect/landmark/bitrunning/cache_goal_turf,
/obj/effect/turf_decal/loading_area,
/obj/effect/turf_decal/loading_area{
	dir = 4
	},
/turf/open/floor/bitrunning_transport,
/area/virtual_domain/safehouse)
"J" = (
/obj/effect/turf_decal/stripes/line{
	dir = 8
	},
/obj/effect/turf_decal/stripes/line{
	dir = 4
	},
/obj/effect/landmark/bitrunning/hololadder_spawn,
/turf/open/floor/iron,
/area/virtual_domain/safehouse)
"M" = (
/obj/effect/turf_decal/tile/neutral{
	dir = 4
	},
/obj/effect/turf_decal/stripes/line{
	dir = 6
	},
/obj/machinery/light/small/directional/south,
/obj/effect/decal/cleanable/dirt,
/obj/effect/landmark/bitrunning/hololadder_spawn,
/turf/open/floor/iron,
/area/virtual_domain/safehouse)
"O" = (
/obj/effect/turf_decal/tile/neutral/fourcorners,
/obj/effect/turf_decal/stripes/line{
	dir = 6
	},
/obj/effect/landmark/bitrunning/hololadder_spawn,
/turf/open/floor/iron,
/area/virtual_domain/safehouse)
"U" = (
/obj/effect/turf_decal/tile/neutral/half/contrasted,
/obj/effect/turf_decal/stripes/line{
	dir = 1
	},
/obj/machinery/light/small/directional/north,
/obj/effect/decal/cleanable/dirt/dust,
/obj/effect/landmark/bitrunning/hololadder_spawn,
/turf/open/floor/iron,
/area/virtual_domain/safehouse)
"W" = (
/obj/effect/turf_decal/tile/neutral/fourcorners,
/obj/effect/turf_decal/stripes/line,
/obj/effect/decal/cleanable/blood/old,
/obj/effect/decal/cleanable/dirt,
/turf/open/floor/iron,
/area/virtual_domain/safehouse)
"Z" = (
/obj/effect/turf_decal/stripes/line{
	dir = 10
	},
/obj/effect/decal/cleanable/generic,
/obj/effect/landmark/bitrunning/hololadder_spawn,
/turf/open/floor/iron,
/area/virtual_domain/safehouse)

(1,1,1) = {"
a
k
i
i
k
a
"}
(2,1,1) = {"
i
j
J
m
c
a
"}
(3,1,1) = {"
a
q
n
W
v
i
"}
(4,1,1) = {"
r
D
G
z
Z
a
"}
(5,1,1) = {"
a
U
p
z
s
i
"}
(6,1,1) = {"
i
F
A
O
M
a
"}
(7,1,1) = {"
a
a
i
i
a
a
"}
