//MAP CONVERTED BY dmm2tgm.py THIS HEADER COMMENT PREVENTS RECONVERSION, DO NOT REMOVE
"aW" = (
/obj/machinery/space_heater,
/turf/open/floor/iron/smooth_large,
/area/ruin/space/has_grav/ntcomms)
"bf" = (
/obj/effect/turf_decal/tile/blue/opposingcorners,
/obj/structure/chair/office{
	dir = 1
	},
/turf/open/floor/iron/dark,
/area/ruin/space/has_grav/ntcomms)
"bG" = (
/turf/open/floor/plating,
/area/ruin/space/has_grav/ntcomms)
"ck" = (
/obj/effect/turf_decal/tile/blue/opposingcorners,
/obj/structure/bookcase/random/adult,
/turf/open/floor/iron/dark,
/area/ruin/space/has_grav/ntcomms)
"cm" = (
/obj/effect/turf_decal/tile/blue/opposingcorners,
/obj/machinery/holopad,
/turf/open/floor/iron/dark,
/area/ruin/space/has_grav/ntcomms)
"co" = (
/obj/structure/cable,
/turf/open/floor/iron/smooth_large,
/area/ruin/space/has_grav/ntcomms)
"cq" = (
/obj/structure/cable,
/turf/closed/wall/r_wall,
/area/ruin/space/has_grav/ntcomms)
"cY" = (
/obj/effect/turf_decal/tile/blue/opposingcorners,
/turf/open/floor/iron/dark,
/area/ruin/space/has_grav/ntcomms)
"dt" = (
/obj/machinery/atmospherics/pipe/smart/manifold4w/supply/hidden,
/obj/structure/cable,
/turf/open/floor/iron/smooth_large,
/area/ruin/space/has_grav/ntcomms)
"dM" = (
/obj/structure/cable,
/obj/machinery/atmospherics/pipe/smart/manifold4w/supply/visible,
/obj/machinery/atmospherics/pipe/smart/manifold4w/scrubbers/visible/layer2,
/turf/open/floor/plating,
/area/ruin/space/has_grav/ntcomms)
"dN" = (
/obj/effect/turf_decal/tile/blue/opposingcorners,
/obj/machinery/computer/crew,
/turf/open/floor/iron/dark,
/area/ruin/space/has_grav/ntcomms)
"ed" = (
/turf/open/floor/iron/smooth_large,
/area/ruin/space/has_grav/ntcomms)
"ez" = (
/obj/structure/cable,
/obj/machinery/atmospherics/pipe/smart/manifold4w/supply/visible,
/obj/machinery/atmospherics/pipe/smart/manifold4w/scrubbers/visible/layer2,
/obj/effect/decal/cleanable/dirt,
/turf/open/floor/plating,
/area/ruin/space/has_grav/ntcomms)
"fd" = (
/obj/effect/decal/cleanable/dirt,
/obj/structure/closet/crate,
/obj/item/stack/sheet/iron/fifty,
/obj/item/stack/sheet/glass/twenty,
/obj/item/stack/sheet/glass/twenty,
/turf/open/floor/iron/smooth_large,
/area/ruin/space/has_grav/ntcomms)
"fz" = (
/obj/machinery/light/cold/dim/directional/south,
/turf/open/floor/iron/smooth_large,
/area/ruin/space/has_grav/ntcomms)
"fF" = (
/obj/machinery/atmospherics/pipe/smart/manifold4w/scrubbers/hidden/layer2,
/turf/closed/wall/r_wall,
/area/ruin/space/has_grav/ntcomms)
"fG" = (
/obj/structure/sign/nanotrasen{
	pixel_x = -32
	},
/turf/open/floor/plating,
/area/ruin/space)
"fL" = (
/obj/effect/turf_decal/tile/blue/opposingcorners,
/obj/machinery/computer/records/medical/syndie{
	dir = 2;
	req_access = list("syndicate")
	},
/turf/open/floor/iron/dark,
/area/ruin/space/has_grav/ntcomms)
"fR" = (
/obj/structure/rack,
/obj/item/pickaxe,
/obj/item/clothing/mask/gas,
/obj/item/mining_scanner,
/turf/open/floor/iron/smooth_large,
/area/ruin/space/has_grav/ntcomms)
"hs" = (
/obj/machinery/atmospherics/components/unary/vent_pump/on{
	dir = 8
	},
/obj/machinery/light/floor,
/turf/open/floor/plating,
/area/ruin/space/has_grav/ntcomms)
"hM" = (
/obj/effect/decal/cleanable/dirt,
/obj/structure/table,
/obj/effect/spawner/random/special_lighter{
	pixel_x = -7
	},
/obj/effect/spawner/random/special_lighter{
	pixel_x = 7
	},
/turf/open/floor/iron/smooth_large,
/area/ruin/space/has_grav/ntcomms)
"iX" = (
/obj/structure/table,
/obj/item/storage/medkit/fire{
	pixel_x = 3;
	pixel_y = 3
	},
/obj/item/storage/medkit/regular{
	pixel_x = -3;
	pixel_y = -3
	},
/obj/machinery/door/window/left/directional/south{
	name = "First-Aid Supplies";
	req_access = list("medical");
	dir = 1
	},
/obj/machinery/light/cold/dim/directional/south,
/turf/open/floor/iron/smooth_large,
/area/ruin/space/has_grav/ntcomms)
"iZ" = (
/obj/machinery/power/apc/worn_out/directional/south,
/obj/structure/cable,
/obj/effect/mapping_helpers/apc/unlocked,
/turf/open/floor/iron/smooth_large,
/area/ruin/space/has_grav/ntcomms)
"jk" = (
/turf/open/floor/plating,
/area/ruin/space)
"mV" = (
/obj/machinery/atmospherics/pipe/smart/manifold4w/scrubbers/hidden/layer2,
/obj/machinery/atmospherics/pipe/smart/manifold4w/scrubbers/hidden/layer2,
/obj/machinery/atmospherics/pipe/smart/manifold4w/scrubbers/hidden/layer2,
/obj/machinery/light/cold/dim/directional/north,
/turf/open/floor/iron/smooth_large,
/area/ruin/space/has_grav/ntcomms)
"nR" = (
/obj/structure/table,
/obj/item/storage/fancy/cigarettes/cigars/cohiba{
	pixel_y = 12
	},
/obj/item/storage/fancy/cigarettes/cigars/cohiba,
/obj/machinery/light/cold/dim/directional/north,
/turf/open/floor/iron/smooth_large,
/area/ruin/space/has_grav/ntcomms)
"nS" = (
/obj/effect/turf_decal/tile/blue/opposingcorners,
/obj/structure/table,
/obj/item/paper/fluff/ruins/ntcomms,
/turf/open/floor/iron/dark,
/area/ruin/space/has_grav/ntcomms)
"nZ" = (
/turf/closed/mineral/random,
/area/ruin/space)
"or" = (
/turf/closed/wall/r_wall,
/area/ruin/space/has_grav/ntcomms)
"oT" = (
/obj/machinery/atmospherics/pipe/smart/manifold4w/scrubbers/hidden/layer2,
/obj/machinery/atmospherics/pipe/smart/manifold4w/scrubbers/hidden/layer2,
/turf/open/floor/iron/smooth_large,
/area/ruin/space/has_grav/ntcomms)
"pA" = (
/obj/effect/turf_decal/tile/blue/opposingcorners,
/obj/machinery/light/cold/dim/directional/north,
/turf/open/floor/iron/dark,
/area/ruin/space/has_grav/ntcomms)
"pL" = (
/obj/effect/turf_decal/tile/blue/opposingcorners,
/obj/machinery/atmospherics/components/unary/vent_pump/on,
/turf/open/floor/iron/dark,
/area/ruin/space/has_grav/ntcomms)
"pS" = (
/obj/machinery/atmospherics/pipe/smart/manifold4w/supply/hidden,
/obj/machinery/atmospherics/pipe/smart/manifold4w/scrubbers/hidden/layer2,
/obj/machinery/light/floor,
/turf/open/floor/iron/white/smooth_large,
/area/ruin/space/has_grav/ntcomms)
"qh" = (
/obj/structure/cable,
/turf/open/floor/iron/white/smooth_large,
/area/ruin/space/has_grav/ntcomms)
"qk" = (
/obj/machinery/light/cold/dim/directional/north,
/obj/structure/cable,
/obj/machinery/power/port_gen/pacman/magical,
/turf/open/floor/plating,
/area/ruin/space/has_grav/ntcomms)
"ry" = (
/obj/structure/table,
/obj/item/storage/box/donkpockets{
	pixel_x = 2;
	pixel_y = 8
	},
/obj/item/storage/box/donkpockets/donkpocketspicy{
	pixel_y = 6
	},
/obj/item/storage/box/donkpockets{
	pixel_x = -2;
	pixel_y = 4
	},
/turf/open/floor/iron/white/smooth_large,
/area/ruin/space/has_grav/ntcomms)
"td" = (
/obj/structure/cable,
/obj/machinery/atmospherics/pipe/smart/manifold4w/supply/hidden,
/obj/machinery/atmospherics/pipe/smart/manifold4w/scrubbers/hidden/layer2,
/turf/open/floor/iron/smooth_large,
/area/ruin/space/has_grav/ntcomms)
"ts" = (
/obj/structure/cable,
/obj/structure/rack,
/obj/item/storage/toolbox/mechanical{
	pixel_y = -1
	},
/turf/open/floor/iron/white/smooth_large,
/area/ruin/space/has_grav/ntcomms)
"tG" = (
/obj/structure/rack,
/obj/item/storage/toolbox/mechanical{
	pixel_y = 3
	},
/obj/item/storage/toolbox/mechanical{
	pixel_y = -6
	},
/turf/open/floor/plating,
/area/ruin/space/has_grav/ntcomms)
"tZ" = (
/obj/effect/turf_decal/tile/blue/opposingcorners,
/obj/machinery/airalarm/directional/north,
/obj/effect/mapping_helpers/airalarm/unlocked,
/turf/open/floor/iron/dark,
/area/ruin/space/has_grav/ntcomms)
"uJ" = (
/obj/structure/extinguisher_cabinet/directional/west,
/turf/open/floor/iron/smooth_large,
/area/ruin/space/has_grav/ntcomms)
"uM" = (
/obj/effect/turf_decal/tile/blue/opposingcorners,
/obj/machinery/computer/message_monitor{
	dir = 8
	},
/obj/item/paper/monitorkey,
/turf/open/floor/iron/dark,
/area/ruin/space/has_grav/ntcomms)
"uV" = (
/obj/docking_port/stationary{
	dwidth = 4;
	height = 5;
	shuttle_id = "caravansyndicate1_listeningpost";
	name = "Nanotrasen Listening Post";
	width = 9
	},
/turf/open/space/basic,
/area/template_noop)
"uX" = (
/obj/effect/decal/cleanable/dirt,
/obj/structure/closet/emcloset/anchored,
/turf/open/floor/plating,
/area/ruin/space/has_grav/ntcomms)
"vE" = (
/obj/structure/sink/directional/west,
/turf/open/floor/iron/white/smooth_large,
/area/ruin/space/has_grav/ntcomms)
"wX" = (
/obj/structure/closet/crate/bin,
/obj/effect/spawner/random/trash/cigbutt,
/obj/effect/spawner/random/trash/cigbutt,
/obj/effect/spawner/random/trash/cigbutt,
/obj/effect/spawner/random/trash/cigbutt,
/obj/machinery/light/cold/dim/directional/north,
/turf/open/floor/iron/smooth_large,
/area/ruin/space/has_grav/ntcomms)
"xb" = (
/obj/machinery/atmospherics/components/unary/vent_pump/on,
/obj/effect/decal/cleanable/dirt,
/turf/open/floor/iron/smooth_large,
/area/ruin/space/has_grav/ntcomms)
"xB" = (
/obj/effect/decal/cleanable/dirt,
/obj/machinery/light/cold/dim/directional/north,
/turf/open/floor/iron/smooth_large,
/area/ruin/space/has_grav/ntcomms)
"xO" = (
/obj/effect/turf_decal/tile/blue/opposingcorners,
/obj/machinery/computer/camera_advanced{
	dir = 8
	},
/turf/open/floor/iron/dark,
/area/ruin/space/has_grav/ntcomms)
"yl" = (
/obj/machinery/atmospherics/pipe/smart/manifold4w/supply/visible,
/obj/effect/decal/cleanable/dirt,
/obj/structure/reagent_dispensers/plumbed,
/turf/open/floor/iron/smooth_large,
/area/ruin/space/has_grav/ntcomms)
"zo" = (
/obj/effect/turf_decal/tile/blue/opposingcorners,
/obj/effect/mob_spawn/ghost_role/human/ntcomms{
	dir = 4
	},
/turf/open/floor/iron/dark,
/area/ruin/space/has_grav/ntcomms)
"zx" = (
/obj/effect/decal/cleanable/dirt,
/obj/structure/closet/emcloset/anchored,
/obj/machinery/light/cold/dim/directional/west,
/turf/open/floor/plating,
/area/ruin/space/has_grav/ntcomms)
"Am" = (
/obj/item/seeds/potato{
	pixel_x = -4;
	pixel_y = 1
	},
/obj/structure/table,
/obj/item/seeds/watermelon,
/obj/item/reagent_containers/cup/watering_can{
	pixel_y = 7;
	pixel_x = 4
	},
/obj/structure/cable,
/obj/machinery/power/apc/worn_out/directional/east,
/obj/effect/mapping_helpers/apc/unlocked,
/turf/open/floor/iron/white/smooth_large,
/area/ruin/space/has_grav/ntcomms)
"AO" = (
/obj/machinery/atmospherics/pipe/smart/manifold4w/supply/hidden,
/obj/machinery/atmospherics/pipe/smart/manifold4w/scrubbers/hidden/layer2,
/obj/machinery/door/airlock/grunge,
/obj/structure/cable,
/turf/open/floor/iron/dark,
/area/ruin/space/has_grav/ntcomms)
"AZ" = (
/obj/structure/cable,
/obj/machinery/atmospherics/pipe/smart/manifold4w/supply/visible,
/obj/machinery/atmospherics/pipe/smart/manifold4w/scrubbers/visible/layer2,
/obj/machinery/door/airlock/grunge,
/turf/open/floor/plating,
/area/ruin/space/has_grav/ntcomms)
"Bm" = (
/obj/effect/spawner/structure/window/reinforced,
/obj/structure/cable,
/turf/open/floor/plating,
/area/ruin/space/has_grav/ntcomms)
"By" = (
/obj/effect/turf_decal/tile/blue/opposingcorners,
/obj/structure/chair/office{
	dir = 4
	},
/turf/open/floor/iron/dark,
/area/ruin/space/has_grav/ntcomms)
"BM" = (
/obj/effect/turf_decal/tile/blue/opposingcorners,
/obj/machinery/telecomms/relay/preset/ruskie{
	use_power = 0
	},
/turf/open/floor/iron/dark,
/area/ruin/space/has_grav/ntcomms)
"Ca" = (
/obj/machinery/computer/arcade/orion_trail{
	dir = 4
	},
/turf/open/floor/iron/smooth_large,
/area/ruin/space/has_grav/ntcomms)
"Ch" = (
/obj/structure/reagent_dispensers/fueltank,
/turf/open/floor/plating,
/area/ruin/space/has_grav/ntcomms)
"CE" = (
/obj/effect/decal/cleanable/dirt,
/obj/structure/table,
/obj/item/storage/fancy/cigarettes/cigpack_robustgold{
	pixel_y = 4;
	pixel_x = 7
	},
/obj/item/storage/fancy/cigarettes/cigpack_robustgold{
	pixel_x = -6;
	pixel_y = 3
	},
/turf/open/floor/iron/smooth_large,
/area/ruin/space/has_grav/ntcomms)
"CK" = (
/obj/structure/cable,
/obj/effect/decal/cleanable/dirt,
/turf/open/floor/iron/smooth_large,
/area/ruin/space/has_grav/ntcomms)
"CN" = (
/obj/effect/turf_decal/tile/blue/opposingcorners,
/obj/structure/rack,
/obj/item/storage/toolbox/mechanical{
	pixel_y = 3
	},
/obj/item/storage/toolbox/mechanical{
	pixel_y = -6
	},
/turf/open/floor/iron/dark,
/area/ruin/space/has_grav/ntcomms)
"DA" = (
/obj/effect/turf_decal/tile/blue/opposingcorners,
/obj/machinery/atmospherics/pipe/smart/manifold4w/supply/hidden,
/obj/machinery/atmospherics/pipe/smart/manifold4w/scrubbers/hidden/layer2,
/obj/effect/turf_decal/tile/blue/opposingcorners,
/turf/open/floor/iron/dark,
/area/ruin/space/has_grav/ntcomms)
"DY" = (
/turf/closed/wall/r_wall,
/area/ruin/space)
"Ey" = (
/obj/machinery/atmospherics/pipe/smart/manifold4w/supply/hidden,
/obj/machinery/atmospherics/pipe/smart/manifold4w/scrubbers/hidden/layer2,
/obj/effect/decal/cleanable/dirt,
/obj/structure/cable,
/turf/open/floor/iron/smooth_large,
/area/ruin/space/has_grav/ntcomms)
"EF" = (
/obj/effect/turf_decal/tile/blue/opposingcorners,
/obj/machinery/light/cold/dim/directional/south,
/turf/open/floor/iron/dark,
/area/ruin/space/has_grav/ntcomms)
"EK" = (
/obj/machinery/door/airlock/external/ruin{
	id_tag = "syndie_listeningpost_external_interior"
	},
/obj/effect/mapping_helpers/airlock/cyclelink_helper_multi{
	cycle_id = "syndicate_comms_base"
	},
/obj/effect/turf_decal/stripes/line{
	dir = 1
	},
/obj/effect/turf_decal/stripes/line,
/obj/structure/cable,
/turf/open/floor/plating,
/area/ruin/space/has_grav/ntcomms)
"Fp" = (
/obj/machinery/atmospherics/pipe/smart/manifold4w/supply/visible,
/obj/structure/cable,
/turf/open/floor/plating,
/area/ruin/space/has_grav/ntcomms)
"Fz" = (
/obj/machinery/atmospherics/pipe/smart/manifold4w/scrubbers/hidden/layer2,
/obj/effect/decal/cleanable/dirt,
/turf/open/floor/iron/smooth_large,
/area/ruin/space/has_grav/ntcomms)
"Gq" = (
/obj/machinery/atmospherics/components/unary/vent_pump/on{
	dir = 8
	},
/obj/machinery/airalarm/directional/east,
/obj/effect/mapping_helpers/airalarm/unlocked,
/turf/open/floor/iron/white/smooth_large,
/area/ruin/space/has_grav/ntcomms)
"GQ" = (
/obj/machinery/airalarm/directional/south,
/obj/effect/mapping_helpers/airalarm/unlocked,
/turf/open/floor/iron/smooth_large,
/area/ruin/space/has_grav/ntcomms)
"GV" = (
/obj/machinery/atmospherics/pipe/smart/manifold4w/scrubbers/hidden/layer2,
/turf/open/floor/iron/smooth_large,
/area/ruin/space/has_grav/ntcomms)
"Hq" = (
/obj/effect/decal/cleanable/dirt,
/obj/machinery/space_heater,
/turf/open/floor/iron/smooth_large,
/area/ruin/space/has_grav/ntcomms)
"HW" = (
/obj/machinery/atmospherics/pipe/smart/manifold4w/supply/hidden,
/obj/machinery/atmospherics/pipe/smart/manifold4w/scrubbers/hidden/layer2,
/obj/structure/cable,
/turf/open/floor/iron/white/smooth_large,
/area/ruin/space/has_grav/ntcomms)
"Im" = (
/obj/machinery/door/airlock/external/ruin{
	id_tag = "syndie_listeningpost_external"
	},
/obj/effect/mapping_helpers/airlock/cyclelink_helper_multi{
	cycle_id = "syndicate_comms_base"
	},
/obj/structure/fans/tiny,
/obj/effect/turf_decal/stripes/line{
	dir = 8
	},
/obj/effect/turf_decal/stripes/line{
	dir = 4
	},
/obj/structure/cable,
/turf/open/floor/plating,
/area/ruin/space/has_grav/ntcomms)
"Iz" = (
/obj/item/weldingtool/largetank,
/obj/item/wrench,
/obj/item/clothing/head/utility/welding,
/obj/structure/rack,
/obj/machinery/light/cold/dim/directional/east,
/turf/open/floor/plating,
/area/ruin/space/has_grav/ntcomms)
"IP" = (
/obj/structure/cable,
/obj/machinery/light/floor,
/turf/open/floor/plating,
/area/ruin/space/has_grav/ntcomms)
"JF" = (
/obj/structure/lattice/catwalk,
/turf/open/space/basic,
/area/template_noop)
"JG" = (
/obj/machinery/suit_storage_unit,
/turf/open/floor/plating,
/area/ruin/space/has_grav/ntcomms)
"Kt" = (
/obj/machinery/atmospherics/components/unary/vent_scrubber/on/layer2{
	dir = 4
	},
/obj/machinery/airalarm/directional/west,
/obj/effect/mapping_helpers/airalarm/unlocked,
/turf/open/floor/iron/smooth_large,
/area/ruin/space/has_grav/ntcomms)
"Kx" = (
/obj/effect/turf_decal/tile/blue/opposingcorners,
/obj/machinery/light/floor,
/turf/open/floor/iron/dark,
/area/ruin/space/has_grav/ntcomms)
"Mc" = (
/obj/effect/turf_decal/tile/blue/opposingcorners,
/obj/machinery/atmospherics/pipe/smart/manifold4w/supply/hidden,
/obj/machinery/atmospherics/pipe/smart/manifold4w/scrubbers/hidden/layer2,
/obj/structure/cable,
/turf/open/floor/iron/dark,
/area/ruin/space/has_grav/ntcomms)
"Mw" = (
/obj/machinery/holopad,
/turf/open/floor/iron/white/smooth_large,
/area/ruin/space/has_grav/ntcomms)
"MJ" = (
/obj/structure/table,
/obj/item/storage/medkit/brute{
	pixel_x = 3;
	pixel_y = 3
	},
/obj/item/storage/medkit/regular{
	pixel_x = -3;
	pixel_y = -3
	},
/obj/structure/window/reinforced/spawner/directional/south{
	dir = 1
	},
/obj/machinery/atmospherics/pipe/smart/manifold4w/scrubbers/hidden/layer2,
/turf/open/floor/iron/smooth_large,
/area/ruin/space/has_grav/ntcomms)
"Nk" = (
/obj/structure/table,
/obj/machinery/microwave{
	pixel_y = 6
	},
/obj/machinery/light/cold/dim/directional/south,
/turf/open/floor/iron/white/smooth_large,
/area/ruin/space/has_grav/ntcomms)
"NY" = (
/turf/open/space/basic,
/area/template_noop)
"Ok" = (
/obj/structure/closet{
	icon_door = "black";
	name = "wardrobe"
	},
/obj/item/clothing/under/color/black{
	pixel_x = -3;
	pixel_y = 3
	},
/obj/item/clothing/under/color/black{
	pixel_x = 1;
	pixel_y = -1
	},
/obj/item/clothing/head/soft/black{
	pixel_x = -3;
	pixel_y = 3
	},
/obj/item/clothing/head/soft/black{
	pixel_x = 1;
	pixel_y = -1
	},
/obj/item/clothing/gloves/fingerless,
/obj/item/clothing/shoes/sneakers/black{
	pixel_x = -3;
	pixel_y = 3
	},
/obj/item/clothing/shoes/sneakers/black{
	pixel_x = 1;
	pixel_y = -1
	},
/obj/effect/turf_decal/tile/blue/opposingcorners,
/turf/open/floor/iron/dark,
/area/ruin/space/has_grav/ntcomms)
"On" = (
/obj/machinery/atmospherics/components/tank/air,
/turf/open/floor/plating,
/area/ruin/space/has_grav/ntcomms)
"OB" = (
/obj/machinery/atmospherics/pipe/smart/manifold4w/supply/hidden,
/obj/machinery/atmospherics/pipe/smart/manifold4w/scrubbers/hidden/layer2,
/obj/machinery/holopad,
/obj/structure/cable,
/turf/open/floor/iron/smooth_large,
/area/ruin/space/has_grav/ntcomms)
"OI" = (
/obj/effect/turf_decal/tile/blue/opposingcorners,
/obj/machinery/atmospherics/pipe/smart/manifold4w/supply/hidden,
/obj/machinery/atmospherics/pipe/smart/manifold4w/scrubbers/hidden/layer2,
/obj/effect/turf_decal/tile/blue/opposingcorners,
/obj/machinery/light/floor,
/turf/open/floor/iron/dark,
/area/ruin/space/has_grav/ntcomms)
"Py" = (
/obj/structure/cable,
/obj/machinery/atmospherics/pipe/smart/manifold4w/supply/hidden,
/obj/machinery/atmospherics/pipe/smart/manifold4w/scrubbers/hidden/layer2,
/obj/machinery/light/cold/dim/directional/north,
/turf/open/floor/iron/smooth_large,
/area/ruin/space/has_grav/ntcomms)
"PJ" = (
/obj/machinery/power/apc/auto_name/directional/west,
/obj/structure/cable,
/obj/machinery/light/cold/dim/directional/south,
/obj/effect/mapping_helpers/apc/unlocked,
/turf/open/floor/iron/smooth_large,
/area/ruin/space/has_grav/ntcomms)
"Qi" = (
/obj/structure/sign/nanotrasen{
	pixel_x = 32
	},
/turf/open/floor/plating,
/area/ruin/space)
"QA" = (
/obj/machinery/atmospherics/components/unary/passive_vent/layer2{
	dir = 4
	},
/obj/structure/lattice/catwalk,
/turf/open/space/basic,
/area/template_noop)
"QW" = (
/obj/machinery/atmospherics/components/unary/vent_scrubber/on/layer2{
	dir = 1
	},
/turf/open/floor/iron/smooth_large,
/area/ruin/space/has_grav/ntcomms)
"Rf" = (
/obj/effect/decal/cleanable/dirt,
/turf/open/floor/iron/smooth_large,
/area/ruin/space/has_grav/ntcomms)
"Rl" = (
/obj/machinery/atmospherics/pipe/smart/manifold4w/supply/hidden,
/obj/machinery/atmospherics/pipe/smart/manifold4w/scrubbers/hidden/layer2,
/obj/structure/cable,
/turf/open/floor/iron/smooth_large,
/area/ruin/space/has_grav/ntcomms)
"Sf" = (
/obj/machinery/atmospherics/pipe/smart/manifold4w/supply/hidden,
/obj/machinery/atmospherics/pipe/smart/manifold4w/scrubbers/hidden/layer2,
/obj/structure/cable,
/obj/structure/cable,
/turf/open/floor/iron/smooth_large,
/area/ruin/space/has_grav/ntcomms)
"Sx" = (
/turf/closed/mineral/random/high_chance,
/area/ruin/space)
"ST" = (
/turf/closed/wall,
/area/ruin/space/has_grav/ntcomms)
"Tm" = (
/obj/machinery/atmospherics/components/unary/vent_scrubber/on/layer2{
	dir = 4
	},
/obj/structure/cable,
/turf/open/floor/iron/white/smooth_large,
/area/ruin/space/has_grav/ntcomms)
"Tz" = (
/obj/machinery/light/cold/dim/directional/west,
/obj/structure/rack,
/obj/item/storage/toolbox/mechanical{
	pixel_y = -1
	},
/obj/item/storage/toolbox/mechanical{
	pixel_y = 3
	},
/turf/open/floor/iron/smooth_large,
/area/ruin/space/has_grav/ntcomms)
"TN" = (
/obj/structure/cable,
/turf/open/floor/plating,
/area/ruin/space)
"UA" = (
/obj/structure/marker_beacon/yellow,
/turf/open/floor/plating,
/area/ruin/space)
"UR" = (
/obj/effect/turf_decal/tile/blue/opposingcorners,
/obj/machinery/atmospherics/components/unary/vent_scrubber/on/layer2{
	dir = 1
	},
/turf/open/floor/iron/dark,
/area/ruin/space/has_grav/ntcomms)
"UU" = (
/obj/machinery/atmospherics/components/tank/air,
/obj/machinery/light/cold/dim/directional/east,
/turf/open/floor/plating,
/area/ruin/space/has_grav/ntcomms)
"We" = (
/obj/effect/turf_decal/tile/blue/opposingcorners,
/obj/structure/bookcase/random/fiction,
/turf/open/floor/iron/dark,
/area/ruin/space/has_grav/ntcomms)
"WD" = (
/obj/effect/turf_decal/tile/blue/opposingcorners,
/obj/machinery/atmospherics/pipe/smart/manifold4w/supply/hidden,
/obj/machinery/atmospherics/pipe/smart/manifold4w/scrubbers/hidden/layer2,
/turf/open/floor/iron/dark,
/area/ruin/space/has_grav/ntcomms)
"Xh" = (
/obj/effect/turf_decal/tile/blue/opposingcorners,
/obj/structure/bookcase/random/nonfiction,
/turf/open/floor/iron/dark,
/area/ruin/space/has_grav/ntcomms)
"XE" = (
/obj/machinery/light/cold/dim/directional/north,
/turf/open/floor/plating,
/area/ruin/space/has_grav/ntcomms)
"XX" = (
/obj/item/stack/sheet/iron/twenty,
/obj/item/stack/sheet/glass{
	amount = 10
	},
/obj/item/stack/rods/ten,
/obj/effect/decal/cleanable/dirt,
/obj/item/storage/box/lights/bulbs,
/obj/item/stack/sheet/mineral/plasma{
	amount = 30
	},
/obj/item/stock_parts/cell/high,
/obj/structure/closet/crate,
/obj/item/stack/sheet/mineral/plasma/thirty,
/obj/item/stack/sheet/mineral/plasma/thirty,
/turf/open/floor/iron/smooth_large,
/area/ruin/space/has_grav/ntcomms)
"Yd" = (
/obj/machinery/atmospherics/pipe/smart/manifold4w/supply/hidden,
/obj/machinery/atmospherics/pipe/smart/manifold4w/scrubbers/hidden/layer2,
/obj/machinery/door/airlock/grunge,
/obj/structure/cable,
/turf/open/floor/iron/white/smooth_large,
/area/ruin/space/has_grav/ntcomms)
"Yj" = (
/obj/machinery/hydroponics/constructable,
/turf/open/floor/iron/white/smooth_large,
/area/ruin/space/has_grav/ntcomms)
"Yq" = (
/obj/structure/cable,
/turf/open/floor/plating,
/area/ruin/space/has_grav/ntcomms)
"Zc" = (
/obj/effect/turf_decal/tile/blue/opposingcorners,
/obj/machinery/light/cold/dim/directional/north,
/obj/structure/cable,
/obj/machinery/power/apc/worn_out/directional/north,
/obj/effect/mapping_helpers/apc/unlocked,
/turf/open/floor/iron/dark,
/area/ruin/space/has_grav/ntcomms)

(1,1,1) = {"
NY
NY
NY
NY
NY
NY
NY
NY
NY
NY
NY
NY
NY
NY
NY
NY
NY
NY
NY
NY
NY
NY
NY
NY
NY
NY
NY
NY
"}
(2,1,1) = {"
NY
NY
NY
NY
NY
NY
NY
NY
NY
NY
NY
NY
NY
NY
NY
NY
NY
NY
NY
NY
NY
NY
NY
NY
NY
NY
NY
NY
"}
(3,1,1) = {"
NY
NY
NY
NY
NY
NY
NY
NY
NY
NY
NY
NY
NY
NY
NY
NY
NY
NY
NY
NY
NY
NY
NY
NY
NY
NY
NY
NY
"}
(4,1,1) = {"
NY
NY
NY
NY
NY
nZ
Sx
nZ
JF
JF
JF
JF
JF
JF
JF
JF
JF
JF
QA
JF
nZ
nZ
NY
NY
NY
NY
NY
NY
"}
(5,1,1) = {"
NY
NY
NY
NY
nZ
nZ
nZ
Sx
nZ
or
or
Bm
Bm
Bm
cq
Bm
Bm
or
fF
Sx
nZ
nZ
nZ
NY
NY
NY
NY
NY
"}
(6,1,1) = {"
NY
NY
NY
nZ
Sx
nZ
Sx
nZ
or
or
ts
Tm
qh
ry
ST
aW
Hq
Tz
fF
or
nZ
Sx
nZ
nZ
NY
NY
NY
NY
"}
(7,1,1) = {"
NY
NY
nZ
nZ
nZ
nZ
nZ
nZ
or
Yj
HW
pS
Mw
Nk
ST
mV
oT
Fz
MJ
or
Sx
nZ
nZ
nZ
nZ
NY
NY
NY
"}
(8,1,1) = {"
NY
NY
jk
DY
nZ
nZ
nZ
nZ
or
Am
HW
Gq
vE
ST
ST
GV
ed
ed
iX
or
nZ
nZ
nZ
nZ
nZ
nZ
NY
NY
"}
(9,1,1) = {"
NY
NY
UA
fG
jk
or
or
or
or
ST
Yd
ST
ST
ST
Ca
GV
ed
fR
ST
or
or
or
or
nZ
nZ
nZ
NY
NY
"}
(10,1,1) = {"
NY
uV
TN
TN
TN
Im
IP
EK
co
CK
td
ed
uJ
Rf
Rf
GV
fz
ST
ST
Xh
We
ck
or
or
Sx
nZ
nZ
NY
"}
(11,1,1) = {"
NY
NY
UA
jk
jk
or
or
or
nR
ed
Rl
Ey
Rl
dt
td
OB
GQ
ST
Ok
cY
Kx
cY
zo
or
nZ
nZ
nZ
NY
"}
(12,1,1) = {"
NY
NY
jk
Qi
nZ
Sx
nZ
or
CE
hM
Rf
ed
ed
Rf
ed
Sf
Rl
AO
Mc
WD
WD
cY
EF
or
Sx
nZ
nZ
NY
"}
(13,1,1) = {"
NY
NY
nZ
DY
nZ
nZ
nZ
or
ST
ST
ST
ST
ST
wX
xb
td
QW
ST
Zc
cY
DA
cY
nS
or
nZ
nZ
nZ
NY
"}
(14,1,1) = {"
NY
NY
nZ
nZ
nZ
Sx
nZ
or
XE
bG
zx
uX
ST
ST
ST
td
ed
ST
tZ
pL
OI
UR
cY
or
nZ
Sx
nZ
NY
"}
(15,1,1) = {"
NY
NY
NY
nZ
nZ
nZ
nZ
or
bG
bG
bG
Rf
Kt
PJ
ST
Py
ed
ST
dN
cY
cm
cY
EF
or
nZ
Sx
nZ
NY
"}
(16,1,1) = {"
NY
NY
NY
NY
nZ
nZ
Sx
or
qk
Yq
co
Fp
ez
dM
AZ
td
iZ
ST
fL
bf
cY
cY
CN
or
nZ
nZ
nZ
NY
"}
(17,1,1) = {"
NY
NY
NY
NY
NY
nZ
nZ
or
or
ed
On
yl
hs
tG
ST
xB
Rf
ST
pA
By
Kx
cY
or
or
nZ
nZ
NY
NY
"}
(18,1,1) = {"
NY
NY
NY
NY
NY
nZ
nZ
nZ
or
or
UU
Ch
JG
Iz
ST
XX
fd
ST
BM
xO
uM
or
or
nZ
Sx
nZ
NY
NY
"}
(19,1,1) = {"
NY
NY
NY
NY
NY
NY
nZ
nZ
Sx
or
or
or
or
or
or
or
or
or
or
or
or
or
nZ
nZ
nZ
nZ
NY
NY
"}
(20,1,1) = {"
NY
NY
NY
NY
NY
NY
NY
nZ
nZ
nZ
nZ
nZ
Sx
nZ
nZ
Sx
nZ
nZ
nZ
Sx
nZ
nZ
nZ
nZ
NY
NY
NY
NY
"}
(21,1,1) = {"
NY
NY
NY
NY
NY
NY
NY
nZ
nZ
nZ
nZ
nZ
nZ
nZ
nZ
nZ
Sx
nZ
nZ
nZ
nZ
nZ
NY
NY
NY
NY
NY
NY
"}
(22,1,1) = {"
NY
NY
NY
NY
NY
NY
NY
NY
NY
NY
NY
nZ
nZ
nZ
nZ
nZ
nZ
nZ
nZ
NY
NY
NY
NY
NY
NY
NY
NY
NY
"}
(23,1,1) = {"
NY
NY
NY
NY
NY
NY
NY
NY
NY
NY
NY
NY
NY
NY
NY
NY
NY
NY
NY
NY
NY
NY
NY
NY
NY
NY
NY
NY
"}
(24,1,1) = {"
NY
NY
NY
NY
NY
NY
NY
NY
NY
NY
NY
NY
NY
NY
NY
NY
NY
NY
NY
NY
NY
NY
NY
NY
NY
NY
NY
NY
"}
(25,1,1) = {"
NY
NY
NY
NY
NY
NY
NY
NY
NY
NY
NY
NY
NY
NY
NY
NY
NY
NY
NY
NY
NY
NY
NY
NY
NY
NY
NY
NY
"}
