//MAP CONVERTED BY dmm2tgm.py THIS HEADER COMMENT PREVENTS RECONVERSION, DO NOT REMOVE
"a" = (
/obj/machinery/power/shuttle_engine/heater{
	dir = 4
	},
/obj/structure/window/reinforced/spawner/directional/west,
/turf/open/floor/plating/airless,
/area/shuttle/arrival)
"e" = (
/obj/structure/closet/wardrobe/black,
/turf/open/floor/mineral/titanium/blue,
/area/shuttle/arrival)
"f" = (
/obj/effect/spawner/structure/window/reinforced/shuttle,
/obj/structure/fans/tiny/invisible,
/turf/open/floor/plating,
/area/shuttle/arrival)
"g" = (
/turf/closed/wall/mineral/titanium,
/area/shuttle/arrival)
"h" = (
/obj/machinery/requests_console/directional/north{
	department = "Arrival shuttle";
	name = "Arrival Shuttle Requests Console"
	},
/obj/machinery/light/directional/north,
/obj/structure/closet/wardrobe/mixed,
/turf/open/floor/mineral/titanium/blue,
/area/shuttle/arrival)
"j" = (
/obj/structure/closet/emcloset,
/obj/machinery/light/directional/west,
/turf/open/floor/mineral/titanium/blue,
/area/shuttle/arrival)
"l" = (
/obj/machinery/power/shuttle_engine/propulsion{
	dir = 4
	},
/obj/docking_port/mobile/arrivals{
	name = "heliostation arrivals shuttle"
	},
/turf/open/floor/plating/airless,
/area/shuttle/arrival)
"o" = (
/obj/machinery/power/shuttle_engine/propulsion/burst/right{
	dir = 4
	},
/turf/open/floor/plating/airless,
/area/shuttle/arrival)
"r" = (
/obj/machinery/door/airlock/titanium{
	name = "Arrivals Shuttle Airlock"
	},
/obj/structure/fans/tiny,
/turf/open/floor/mineral/titanium/blue,
/area/shuttle/arrival)
"t" = (
/obj/machinery/power/shuttle_engine/propulsion{
	dir = 4
	},
/turf/open/floor/plating/airless,
/area/shuttle/arrival)
"v" = (
/obj/structure/closet/wardrobe/grey,
/turf/open/floor/mineral/titanium/blue,
/area/shuttle/arrival)
"C" = (
/turf/open/floor/mineral/titanium,
/area/shuttle/arrival)
"D" = (
/obj/machinery/power/shuttle_engine/propulsion/burst/left{
	dir = 4
	},
/turf/open/floor/plating/airless,
/area/shuttle/arrival)
"F" = (
/obj/structure/fans/tiny/invisible,
/obj/effect/spawner/structure/window/reinforced/shuttle,
/turf/open/floor/plating,
/area/shuttle/arrival)
"G" = (
/obj/item/radio/intercom/directional/south,
/obj/machinery/light/directional/south,
/turf/open/floor/mineral/titanium/blue,
/area/shuttle/arrival)
"L" = (
/obj/structure/chair/comfy/shuttle{
	dir = 8
	},
/turf/open/floor/mineral/titanium,
/area/shuttle/arrival)
"N" = (
/obj/structure/closet/wardrobe/green,
/turf/open/floor/mineral/titanium/blue,
/area/shuttle/arrival)
"O" = (
/obj/effect/spawner/random/entertainment/arcade,
/obj/machinery/light/directional/north,
/turf/open/floor/mineral/titanium/blue,
/area/shuttle/arrival)
"Q" = (
/obj/structure/table,
/obj/item/storage/medkit/regular,
/obj/machinery/light/directional/west,
/turf/open/floor/mineral/titanium/blue,
/area/shuttle/arrival)
"U" = (
/obj/machinery/light/directional/south,
/turf/open/floor/mineral/titanium/blue,
/area/shuttle/arrival)
"V" = (
/turf/template_noop,
/area/template_noop)
"Y" = (
/turf/open/floor/mineral/titanium/blue,
/area/shuttle/arrival)

(1,1,1) = {"
V
g
F
F
F
g
V
"}
(2,1,1) = {"
g
Q
C
C
C
j
g
"}
(3,1,1) = {"
g
e
L
L
L
Y
g
"}
(4,1,1) = {"
g
O
Y
Y
Y
G
g
"}
(5,1,1) = {"
F
Y
L
L
L
Y
f
"}
(6,1,1) = {"
r
Y
Y
Y
Y
Y
r
"}
(7,1,1) = {"
r
Y
L
L
L
Y
r
"}
(8,1,1) = {"
f
v
Y
Y
Y
Y
f
"}
(9,1,1) = {"
g
h
L
L
L
U
g
"}
(10,1,1) = {"
g
N
C
C
C
Y
g
"}
(11,1,1) = {"
g
a
a
a
a
a
g
"}
(12,1,1) = {"
V
o
t
l
t
D
V
"}
