//MAP CONVERTED BY dmm2tgm.py THIS HEADER COMMENT PREVENTS RECONVERSION, DO NOT REMOVE
"a" = (
/turf/open/floor/mineral/titanium,
/area/shuttle/arrival)
"b" = (
/obj/effect/turf_decal/caution,
/obj/effect/turf_decal/stripes,
/turf/open/floor/mineral/titanium/blue,
/area/shuttle/arrival)
"c" = (
/obj/structure/chair/comfy/shuttle{
	dir = 1
	},
/turf/open/floor/mineral/titanium/blue,
/area/shuttle/arrival)
"d" = (
/obj/structure/chair/comfy/shuttle,
/obj/item/radio/intercom/directional/north,
/turf/open/floor/mineral/titanium/blue,
/area/shuttle/arrival)
"h" = (
/obj/machinery/light/directional/north,
/obj/machinery/vending/clothing,
/obj/effect/turf_decal/delivery,
/turf/open/floor/mineral/titanium/blue,
/area/shuttle/arrival)
"j" = (
/obj/machinery/power/shuttle_engine/propulsion{
	dir = 4
	},
/turf/open/floor/plating/airless,
/area/shuttle/arrival)
"k" = (
/obj/effect/turf_decal/stripes,
/obj/machinery/vending/cigarette,
/obj/effect/turf_decal/delivery,
/obj/machinery/light/directional/south,
/turf/open/floor/mineral/titanium/blue,
/area/shuttle/arrival)
"l" = (
/obj/item/reagent_containers/cup/glass/coffee{
	pixel_x = 8;
	pixel_y = 12
	},
/obj/item/reagent_containers/cup/glass/coffee{
	pixel_x = -7;
	pixel_y = 2
	},
/obj/item/cigarette/rollie/cannabis{
	pixel_x = 8;
	pixel_y = 3
	},
/obj/structure/table/reinforced/rglass,
/turf/open/floor/mineral/titanium,
/area/shuttle/arrival)
"n" = (
/turf/open/floor/mineral/titanium/blue,
/area/shuttle/arrival)
"o" = (
/obj/effect/spawner/structure/window/reinforced/shuttle,
/turf/open/floor/plating,
/area/shuttle/arrival)
"p" = (
/obj/item/clothing/suit/hazardvest{
	desc = "A high-visibility lifejacket complete with whistle and slot for oxygen tanks.";
	name = "emergency lifejacket"
	},
/obj/item/clothing/suit/hazardvest{
	desc = "A high-visibility lifejacket complete with whistle and slot for oxygen tanks.";
	name = "emergency lifejacket"
	},
/obj/item/clothing/suit/hazardvest{
	desc = "A high-visibility lifejacket complete with whistle and slot for oxygen tanks.";
	name = "emergency lifejacket"
	},
/obj/item/clothing/suit/hazardvest{
	desc = "A high-visibility lifejacket complete with whistle and slot for oxygen tanks.";
	name = "emergency lifejacket"
	},
/obj/item/clothing/suit/hazardvest{
	desc = "A high-visibility lifejacket complete with whistle and slot for oxygen tanks.";
	name = "emergency lifejacket"
	},
/obj/item/tank/internals/emergency_oxygen{
	pixel_x = 3
	},
/obj/item/tank/internals/emergency_oxygen{
	pixel_x = 3
	},
/obj/item/tank/internals/emergency_oxygen{
	pixel_x = 3
	},
/obj/item/tank/internals/emergency_oxygen{
	pixel_x = 3
	},
/obj/item/tank/internals/emergency_oxygen{
	pixel_x = 3
	},
/obj/item/clothing/mask/breath{
	pixel_x = -3;
	pixel_y = -3
	},
/obj/item/clothing/mask/breath{
	pixel_x = -3;
	pixel_y = -3
	},
/obj/item/clothing/mask/breath{
	pixel_x = -3;
	pixel_y = -3
	},
/obj/item/clothing/mask/breath{
	pixel_x = -3;
	pixel_y = -3
	},
/obj/item/clothing/mask/breath{
	pixel_x = -3;
	pixel_y = -3
	},
/obj/item/clothing/head/utility/hardhat/orange{
	name = "protective hat";
	pixel_y = 9
	},
/obj/item/clothing/head/utility/hardhat/orange{
	name = "protective hat";
	pixel_y = 9
	},
/obj/item/clothing/head/utility/hardhat/orange{
	name = "protective hat";
	pixel_y = 9
	},
/obj/item/clothing/head/utility/hardhat/orange{
	name = "protective hat";
	pixel_y = 9
	},
/obj/item/clothing/head/utility/hardhat/orange{
	name = "protective hat";
	pixel_y = 9
	},
/obj/structure/closet/crate/internals,
/obj/effect/turf_decal/bot,
/obj/machinery/light/directional/north,
/turf/open/floor/iron,
/area/shuttle/arrival)
"r" = (
/obj/item/radio/intercom/directional/west,
/turf/open/floor/mineral/titanium,
/area/shuttle/arrival)
"u" = (
/obj/structure/closet/wardrobe/mixed,
/obj/effect/turf_decal/delivery,
/turf/open/floor/mineral/titanium/blue,
/area/shuttle/arrival)
"v" = (
/obj/item/storage/medkit/regular,
/obj/structure/table/reinforced/rglass,
/obj/machinery/requests_console/directional/north{
	department = "Arrival shuttle";
	name = "Arrival Shuttle Requests Console"
	},
/turf/open/floor/mineral/titanium/blue,
/area/shuttle/arrival)
"w" = (
/obj/structure/chair/comfy/shuttle{
	dir = 8
	},
/turf/open/floor/mineral/titanium,
/area/shuttle/arrival)
"x" = (
/obj/effect/turf_decal/caution/stand_clear,
/obj/effect/turf_decal/stripes,
/turf/open/floor/mineral/titanium/blue,
/area/shuttle/arrival)
"B" = (
/obj/machinery/power/shuttle_engine/heater{
	dir = 4
	},
/obj/structure/window/reinforced/spawner/directional/west,
/turf/open/floor/plating/airless,
/area/shuttle/arrival)
"E" = (
/obj/effect/turf_decal/stripes,
/turf/open/floor/mineral/titanium/blue,
/area/shuttle/arrival)
"F" = (
/obj/machinery/power/shuttle_engine/propulsion{
	dir = 4
	},
/obj/docking_port/mobile/arrivals,
/turf/open/floor/plating/airless,
/area/shuttle/arrival)
"G" = (
/obj/machinery/light/directional/east,
/turf/open/floor/mineral/titanium/blue,
/area/shuttle/arrival)
"H" = (
/obj/machinery/door/airlock/titanium{
	name = "Arrivals Shuttle Airlock"
	},
/turf/open/floor/mineral/titanium,
/area/shuttle/arrival)
"I" = (
/obj/structure/chair/comfy/shuttle{
	dir = 4
	},
/turf/open/floor/mineral/titanium/blue,
/area/shuttle/arrival)
"L" = (
/obj/structure/closet/wardrobe/black,
/obj/effect/turf_decal/delivery,
/turf/open/floor/mineral/titanium/blue,
/area/shuttle/arrival)
"M" = (
/obj/structure/closet/emcloset,
/obj/effect/turf_decal/delivery,
/obj/effect/turf_decal/stripes,
/obj/machinery/light/directional/south,
/turf/open/floor/mineral/titanium/blue,
/area/shuttle/arrival)
"N" = (
/obj/structure/closet/wardrobe/grey,
/obj/effect/turf_decal/delivery,
/turf/open/floor/mineral/titanium/blue,
/area/shuttle/arrival)
"P" = (
/obj/machinery/door/airlock/titanium{
	name = "Arrivals Shuttle Airlock"
	},
/turf/open/floor/plating,
/area/shuttle/arrival)
"Q" = (
/obj/structure/closet/wardrobe/green,
/obj/effect/turf_decal/delivery,
/turf/open/floor/mineral/titanium/blue,
/area/shuttle/arrival)
"U" = (
/turf/closed/wall/mineral/titanium,
/area/shuttle/arrival)
"W" = (
/turf/template_noop,
/area/template_noop)
"Z" = (
/obj/structure/window/reinforced/spawner/directional/west,
/obj/machinery/power/shuttle_engine/heater{
	dir = 4
	},
/turf/open/floor/plating/airless,
/area/shuttle/arrival)

(1,1,1) = {"
W
U
o
o
o
U
W
"}
(2,1,1) = {"
U
U
I
l
I
U
U
"}
(3,1,1) = {"
U
d
G
a
G
c
U
"}
(4,1,1) = {"
U
U
U
H
U
U
U
"}
(5,1,1) = {"
U
v
a
a
r
M
U
"}
(6,1,1) = {"
P
n
w
w
w
E
o
"}
(7,1,1) = {"
U
h
n
n
n
b
o
"}
(8,1,1) = {"
o
Q
w
w
w
E
o
"}
(9,1,1) = {"
o
L
n
n
n
x
o
"}
(10,1,1) = {"
o
u
w
w
w
E
o
"}
(11,1,1) = {"
o
N
n
n
n
b
o
"}
(12,1,1) = {"
U
p
w
w
w
E
o
"}
(13,1,1) = {"
P
n
a
a
a
k
U
"}
(14,1,1) = {"
U
Z
U
B
U
Z
U
"}
(15,1,1) = {"
U
j
U
F
U
j
U
"}
