//MAP CONVERTED BY dmm2tgm.py THIS HEADER COMMENT PREVENTS RECONVERSION, DO NOT REMOVE
"a" = (
/turf/open/floor/mineral/titanium/white,
/area/shuttle/supply)
"d" = (
/obj/machinery/conveyor{
	id = "QMLoad"
	},
/turf/open/floor/mineral/titanium/purple,
/area/shuttle/supply)
"e" = (
/obj/effect/mapping_helpers/airlock/access/all/supply/general,
/obj/machinery/door/airlock/titanium{
	name = "Supply Shuttle Airlock"
	},
/turf/open/floor/mineral/titanium/blue,
/area/shuttle/supply)
"f" = (
/obj/structure/window/reinforced/spawner/directional/west,
/obj/structure/window/reinforced/spawner/directional/east,
/obj/machinery/power/shuttle_engine/propulsion/burst/left{
	dir = 1
	},
/turf/open/floor/plating/airless,
/area/shuttle/supply)
"g" = (
/obj/machinery/conveyor{
	dir = 8;
	id = "QMLoad"
	},
/obj/structure/plasticflaps/opaque,
/turf/open/floor/mineral/titanium/purple,
/area/shuttle/supply)
"i" = (
/turf/open/floor/mineral/titanium/purple,
/area/shuttle/supply)
"j" = (
/obj/machinery/light/directional/west,
/obj/machinery/conveyor{
	id = "QMLoad2"
	},
/turf/open/floor/mineral/titanium/blue,
/area/shuttle/supply)
"l" = (
/obj/machinery/light/directional/west,
/obj/machinery/conveyor{
	id = "QMLoad"
	},
/turf/open/floor/mineral/titanium/purple,
/area/shuttle/supply)
"m" = (
/obj/effect/spawner/structure/window/reinforced,
/turf/open/floor/plating/airless,
/area/shuttle/supply)
"n" = (
/obj/machinery/light/directional/west,
/turf/open/floor/mineral/titanium/white,
/area/shuttle/supply)
"p" = (
/turf/closed/wall/mineral/titanium,
/area/shuttle/supply)
"s" = (
/obj/structure/window/reinforced/spawner/directional/west,
/obj/structure/window/reinforced/spawner/directional/east,
/obj/structure/window/reinforced/spawner/directional/south,
/obj/machinery/power/shuttle_engine/heater{
	dir = 1
	},
/turf/open/floor/plating/airless,
/area/shuttle/supply)
"u" = (
/obj/machinery/conveyor{
	dir = 6;
	id = "QMLoad2"
	},
/turf/open/floor/mineral/titanium/blue,
/area/shuttle/supply)
"z" = (
/obj/machinery/conveyor_switch/oneway{
	dir = 1;
	id = "QMLoad"
	},
/turf/open/floor/mineral/titanium/purple,
/area/shuttle/supply)
"D" = (
/turf/open/floor/mineral/titanium/blue,
/area/shuttle/supply)
"G" = (
/obj/machinery/power/shuttle_engine/heater,
/obj/structure/window/reinforced/spawner/directional/north,
/obj/structure/window/reinforced/spawner/directional/west,
/obj/structure/window/reinforced/spawner/directional/east,
/turf/open/floor/plating/airless,
/area/shuttle/supply)
"H" = (
/obj/machinery/light/directional/east,
/turf/open/floor/mineral/titanium/white,
/area/shuttle/supply)
"I" = (
/obj/machinery/light/directional/east,
/turf/open/floor/mineral/titanium/blue,
/area/shuttle/supply)
"K" = (
/obj/effect/mapping_helpers/airlock/access/all/supply/general,
/obj/machinery/door/airlock/titanium{
	name = "Supply Shuttle Airlock"
	},
/obj/docking_port/mobile/supply{
	dir = 4
	},
/turf/open/floor/mineral/titanium/purple,
/area/shuttle/supply)
"M" = (
/obj/machinery/conveyor{
	dir = 4;
	id = "QMLoad2"
	},
/obj/structure/plasticflaps/opaque,
/turf/open/floor/mineral/titanium/blue,
/area/shuttle/supply)
"O" = (
/obj/machinery/light/directional/east,
/turf/open/floor/mineral/titanium/purple,
/area/shuttle/supply)
"P" = (
/obj/machinery/conveyor{
	dir = 10;
	id = "QMLoad"
	},
/turf/open/floor/mineral/titanium/purple,
/area/shuttle/supply)
"S" = (
/obj/structure/window/reinforced/spawner/directional/east,
/obj/structure/window/reinforced/spawner/directional/west,
/obj/structure/window/reinforced/spawner/directional/south,
/obj/machinery/power/shuttle_engine/heater{
	dir = 1
	},
/turf/open/floor/plating/airless,
/area/shuttle/supply)
"T" = (
/obj/structure/window/reinforced/spawner/directional/east,
/obj/structure/window/reinforced/spawner/directional/west,
/obj/machinery/power/shuttle_engine/propulsion/burst/left{
	dir = 1
	},
/turf/open/floor/plating/airless,
/area/shuttle/supply)
"V" = (
/obj/machinery/conveyor_switch/oneway{
	id = "QMLoad2"
	},
/turf/open/floor/mineral/titanium/blue,
/area/shuttle/supply)
"W" = (
/obj/machinery/conveyor{
	id = "QMLoad2"
	},
/turf/open/floor/mineral/titanium/blue,
/area/shuttle/supply)
"Z" = (
/obj/machinery/power/shuttle_engine/propulsion/burst/left,
/obj/structure/window/reinforced/spawner/directional/west,
/obj/structure/window/reinforced/spawner/directional/east,
/turf/open/floor/plating/airless,
/area/shuttle/supply)

(1,1,1) = {"
T
S
p
g
K
m
e
M
p
p
G
Z
"}
(2,1,1) = {"
p
d
l
P
i
n
D
u
W
j
W
p
"}
(3,1,1) = {"
p
i
z
a
a
a
a
a
a
V
D
p
"}
(4,1,1) = {"
p
i
i
a
a
a
a
a
a
D
D
p
"}
(5,1,1) = {"
p
i
i
a
a
a
a
a
a
D
D
p
"}
(6,1,1) = {"
p
i
O
a
a
H
a
a
a
I
D
p
"}
(7,1,1) = {"
f
s
p
p
p
p
p
p
p
p
G
Z
"}
