//MAP CONVERTED BY dmm2tgm.py THIS HEADER COMMENT PREVENTS RECONVERSION, DO NOT REMOVE
"a" = (
/turf/template_noop,
/area/template_noop)
"l" = (
/obj/effect/spawner/deleter/space,
/turf/open/space/basic,
/area/template_noop)
"o" = (
/obj/effect/spawner/deleter,
/turf/open/floor/engine,
/area/space)
"p" = (
/obj/effect/spawner/deleter,
/turf/open/floor/iron,
/area/space)
"v" = (
/obj/effect/spawner/deleter,
/turf/closed/wall/r_wall,
/area/space)
"B" = (
/obj/effect/spawner/deleter,
/turf/open/floor/iron/dark,
/area/space)
"N" = (
/obj/effect/spawner/deleter/space,
/turf/open/space/basic,
/area/space)
"W" = (
/obj/effect/spawner/deleter,
/turf/open/floor/plating,
/area/space)
"X" = (
/obj/effect/spawner/deleter/atmoshpherics,
/turf/open/floor/plating,
/area/space)

(1,1,1) = {"
a
a
a
a
v
W
X
W
v
v
W
W
W
v
v
W
W
X
v
a
a
a
a
a
a
"}
(2,1,1) = {"
a
a
a
a
v
o
o
o
o
o
o
o
o
o
o
o
o
o
v
a
a
a
a
a
a
"}
(3,1,1) = {"
a
a
a
a
W
o
o
o
o
o
o
o
o
o
o
o
o
o
v
a
a
a
a
a
a
"}
(4,1,1) = {"
a
a
a
a
W
o
o
B
B
v
v
o
v
v
B
B
o
o
v
a
a
a
a
a
a
"}
(5,1,1) = {"
v
B
v
W
v
o
o
B
B
v
o
o
o
v
B
B
o
o
v
a
a
a
a
a
a
"}
(6,1,1) = {"
B
B
B
B
B
o
o
v
v
v
v
o
v
v
v
v
o
o
v
a
a
a
a
a
a
"}
(7,1,1) = {"
B
B
B
B
W
o
o
W
o
o
o
o
o
o
o
W
o
o
v
a
a
a
a
a
a
"}
(8,1,1) = {"
B
B
B
B
W
o
o
W
o
o
o
o
o
o
o
W
o
o
X
a
a
a
a
a
a
"}
(9,1,1) = {"
B
B
B
B
W
o
o
W
o
o
o
o
o
o
o
W
o
o
v
a
a
a
a
a
a
"}
(10,1,1) = {"
B
B
B
B
B
o
o
v
v
v
v
W
v
v
v
v
o
o
W
N
N
a
a
a
a
"}
(11,1,1) = {"
v
v
v
W
v
o
o
o
o
o
o
B
o
o
o
o
o
o
W
N
N
N
N
N
a
"}
(12,1,1) = {"
a
a
a
l
W
o
o
o
o
o
o
B
o
o
o
o
o
o
W
N
N
N
N
N
a
"}
(13,1,1) = {"
a
a
a
a
v
W
W
W
v
v
W
W
W
v
v
W
W
W
v
N
N
N
N
N
a
"}
(14,1,1) = {"
a
a
a
a
v
B
W
W
B
B
B
B
B
B
B
W
W
B
v
N
N
N
N
N
a
"}
(15,1,1) = {"
a
a
a
a
v
B
W
W
B
B
B
B
B
B
B
W
W
B
v
N
N
N
N
N
a
"}
(16,1,1) = {"
a
a
a
a
v
B
W
W
B
B
B
B
B
B
B
W
W
B
v
N
N
N
N
N
a
"}
(17,1,1) = {"
a
a
a
a
v
W
W
W
W
W
W
v
W
W
W
W
W
B
v
N
N
N
N
N
a
"}
(18,1,1) = {"
a
a
a
a
v
v
v
v
v
v
v
v
v
v
v
v
v
v
v
N
N
N
N
N
a
"}
(19,1,1) = {"
a
a
a
a
p
p
p
p
p
p
p
p
p
p
p
p
p
p
p
N
N
N
N
N
a
"}
(20,1,1) = {"
a
a
a
a
p
p
p
p
p
p
p
p
p
p
p
p
p
p
p
a
a
a
a
a
a
"}
(21,1,1) = {"
a
a
a
a
p
p
p
p
p
p
p
p
p
p
p
p
p
p
p
a
a
a
a
a
a
"}
(22,1,1) = {"
a
a
a
a
p
p
p
p
p
p
p
p
p
p
p
p
p
p
p
a
a
a
a
a
a
"}
(23,1,1) = {"
a
a
a
a
p
p
p
p
p
p
p
p
p
p
p
p
p
p
p
a
a
a
a
a
a
"}
(24,1,1) = {"
a
a
a
a
p
p
p
p
p
p
p
p
p
p
p
p
p
p
p
a
a
a
a
a
a
"}
(25,1,1) = {"
a
a
a
a
p
p
p
p
p
p
p
p
p
p
p
p
p
p
p
a
a
a
a
a
a
"}
(26,1,1) = {"
a
a
a
a
p
p
p
p
p
p
p
p
p
p
p
p
p
p
p
a
a
a
a
a
a
"}
(27,1,1) = {"
a
a
a
a
p
p
p
p
p
p
p
p
p
p
p
p
p
p
p
a
a
a
a
a
a
"}
(28,1,1) = {"
a
a
a
a
p
p
p
p
p
p
p
p
p
p
p
p
p
p
p
a
a
a
a
a
a
"}
(29,1,1) = {"
a
a
a
a
p
p
p
p
p
p
p
p
p
p
p
p
p
p
p
a
a
a
a
a
a
"}
(30,1,1) = {"
a
a
a
a
p
p
p
p
p
p
p
p
p
p
p
p
p
p
p
a
a
a
a
a
a
"}
(31,1,1) = {"
a
a
a
a
a
a
a
a
a
a
a
a
a
a
a
a
a
a
a
a
a
a
a
a
a
"}
(32,1,1) = {"
a
a
a
a
a
a
a
a
a
a
a
a
a
a
a
a
a
a
a
a
a
a
a
a
a
"}
(33,1,1) = {"
a
a
a
a
a
a
a
a
a
a
a
a
a
a
a
a
a
a
a
a
a
a
a
a
a
"}
