//MAP CONVERTED BY dmm2tgm.py THIS HEADER COMMENT PREVENTS RECONVERSION, DO NOT REMOVE
"af" = (
/obj/structure/cable,
/obj/effect/turf_decal/stripes/line{
	dir = 1
	},
/obj/machinery/atmospherics/pipe/smart/manifold4w/supply/hidden/layer4,
/obj/machinery/atmospherics/pipe/smart/manifold4w/scrubbers/hidden/layer2,
/turf/open/floor/plating,
/area/station/engineering/singularity/room)
"ah" = (
/obj/machinery/atmospherics/pipe/smart/simple/orange/hidden{
	dir = 1
	},
/obj/effect/mapping_helpers/broken_floor,
/obj/effect/landmark/keep/duct,
/turf/open/floor/plating,
/area/station/maintenance/department/engine)
"aP" = (
/obj/machinery/atmospherics/components/unary/vent_scrubber/on/layer2{
	dir = 8
	},
/turf/open/floor/iron/dark,
/area/station/engineering/singularity/room)
"aX" = (
/obj/machinery/atmospherics/pipe/smart/manifold4w/supply/hidden/layer4,
/turf/open/floor/iron/dark,
/area/station/engineering/singularity/room)
"bp" = (
/obj/structure/cable/multilayer/connected,
/turf/open/floor/plating/airless,
/area/space/nearstation)
"bM" = (
/turf/closed/wall/r_wall,
/area/space/nearstation)
"ch" = (
/obj/structure/chair/sofa/corp/right,
/obj/item/radio/intercom/directional/north,
/obj/machinery/light/directional/west,
/turf/open/floor/carpet/black,
/area/station/engineering/singularity/room)
"ck" = (
/obj/effect/spawner/structure/window/reinforced/plasma,
/obj/structure/cable,
/obj/machinery/atmospherics/pipe/smart/manifold4w/supply/hidden/layer4,
/obj/machinery/atmospherics/pipe/smart/manifold4w/scrubbers/hidden/layer2,
/turf/open/floor/plating,
/area/station/engineering/singularity/room)
"cP" = (
/obj/structure/sign/warning/vacuum/external/directional/south,
/obj/machinery/light/directional/south,
/turf/open/floor/plating,
/area/station/engineering/singularity/room)
"dx" = (
/obj/effect/turf_decal/stripes/line{
	dir = 1
	},
/turf/open/floor/iron,
/area/station/engineering/singularity/room)
"dD" = (
/obj/effect/turf_decal/stripes/line{
	dir = 1
	},
/obj/structure/cable,
/obj/machinery/atmospherics/pipe/smart/manifold4w/supply/hidden/layer4,
/obj/machinery/atmospherics/pipe/smart/manifold4w/scrubbers/hidden/layer2,
/turf/open/floor/iron,
/area/station/engineering/singularity/room)
"dT" = (
/obj/structure/cable,
/obj/effect/turf_decal/bot_white/left,
/turf/open/floor/plating/airless,
/area/space/nearstation)
"eg" = (
/turf/open/floor/carpet/black,
/area/station/engineering/singularity/room)
"eH" = (
/obj/structure/lattice/catwalk,
/obj/machinery/camera/emp_proof/directional/west{
	c_tag = "Singularity Engine #4"
	},
/turf/open/space/basic,
/area/space/nearstation)
"eP" = (
/obj/machinery/atmospherics/pipe/smart/simple/orange/hidden{
	dir = 1
	},
/obj/effect/turf_decal/stripes/line,
/obj/effect/landmark/keep/duct,
/turf/open/floor/plating,
/area/station/maintenance/department/engine)
"eS" = (
/obj/machinery/atmospherics/pipe/smart/simple/orange/hidden{
	dir = 1
	},
/turf/open/floor/plating,
/area/station/maintenance/department/engine)
"eT" = (
/obj/effect/turf_decal/stripes/line,
/obj/machinery/atmospherics/components/unary/vent_pump/on/layer4{
	dir = 1
	},
/turf/open/floor/iron,
/area/station/engineering/singularity/room)
"gk" = (
/obj/machinery/atmospherics/components/unary/vent_pump/on/layer4,
/turf/open/floor/iron/dark,
/area/station/engineering/singularity/room)
"gQ" = (
/obj/machinery/the_singularitygen,
/obj/structure/cable,
/obj/machinery/atmospherics/pipe/smart/manifold4w/supply/hidden/layer4,
/obj/machinery/atmospherics/pipe/smart/manifold4w/scrubbers/hidden/layer2,
/turf/open/floor/iron/dark,
/area/station/engineering/singularity/room)
"hn" = (
/obj/effect/turf_decal/stripes/line,
/turf/open/floor/iron,
/area/station/engineering/singularity/room)
"hW" = (
/obj/structure/lattice/catwalk,
/obj/structure/cable,
/turf/open/space/basic,
/area/space/nearstation)
"je" = (
/turf/template_noop,
/area/template_noop)
"kc" = (
/obj/machinery/atmospherics/components/unary/portables_connector/visible,
/turf/open/floor/plating,
/area/station/maintenance/department/engine)
"kO" = (
/obj/effect/spawner/structure/window/reinforced/plasma,
/turf/open/floor/plating,
/area/station/engineering/singularity/room)
"ll" = (
/obj/machinery/door/firedoor,
/obj/structure/cable,
/obj/machinery/door/airlock/engineering/glass{
	name = "Supermatter Engine Room"
	},
/obj/effect/mapping_helpers/airlock/access/all/engineering/general,
/turf/open/floor/iron,
/area/station/engineering/singularity/room)
"lM" = (
/obj/structure/cable,
/turf/open/floor/carpet/black,
/area/station/engineering/singularity/room)
"lP" = (
/obj/effect/turf_decal/stripes/line{
	dir = 1
	},
/obj/effect/landmark/keep/lightning,
/turf/open/floor/iron,
/area/station/engineering/singularity/room)
"mz" = (
/obj/effect/spawner/structure/window/reinforced/plasma,
/obj/machinery/atmospherics/pipe/smart/manifold4w/supply/hidden/layer4,
/turf/open/floor/plating,
/area/station/engineering/singularity/room)
"mC" = (
/obj/machinery/atmospherics/pipe/smart/manifold4w/supply/hidden/layer4,
/obj/machinery/atmospherics/pipe/smart/manifold4w/scrubbers/hidden/layer2,
/turf/open/floor/iron/dark,
/area/station/engineering/singularity/room)
"np" = (
/obj/machinery/the_singularitygen/tesla,
/obj/structure/cable,
/obj/machinery/atmospherics/pipe/smart/manifold4w/supply/hidden/layer4,
/obj/machinery/atmospherics/pipe/smart/manifold4w/scrubbers/hidden/layer2,
/obj/effect/landmark/keep/lightning,
/turf/open/floor/iron/dark,
/area/station/engineering/singularity/room)
"nx" = (
/obj/structure/cable,
/obj/machinery/atmospherics/pipe/smart/manifold4w/supply/hidden/layer4,
/obj/machinery/atmospherics/pipe/smart/manifold4w/scrubbers/hidden/layer2,
/turf/open/floor/carpet/black,
/area/station/engineering/singularity/room)
"nM" = (
/obj/structure/lattice,
/turf/open/space/basic,
/area/space/nearstation)
"oj" = (
/obj/machinery/door/firedoor,
/obj/machinery/door/airlock/engineering/glass{
	name = "Supermatter Engine Room"
	},
/obj/effect/mapping_helpers/airlock/access/all/engineering/general,
/turf/open/floor/iron,
/area/station/engineering/singularity/room)
"ok" = (
/obj/machinery/door/airlock/external,
/obj/effect/mapping_helpers/airlock/access/all/engineering/general,
/obj/effect/mapping_helpers/airlock/cyclelink_helper{
	dir = 4
	},
/obj/structure/cable,
/obj/structure/cable/layer1,
/turf/open/floor/plating,
/area/station/engineering/singularity/room)
"ol" = (
/obj/structure/lattice/catwalk,
/obj/structure/cable,
/obj/structure/cable/layer1,
/turf/open/space/basic,
/area/space/nearstation)
"oW" = (
/obj/structure/table/reinforced,
/turf/open/floor/carpet/black,
/area/station/engineering/singularity/room)
"pi" = (
/obj/structure/reagent_dispensers/watertank,
/obj/effect/turf_decal/stripes/corner{
	dir = 4
	},
/turf/open/floor/plating,
/area/station/maintenance/department/engine)
"qo" = (
/obj/machinery/door/airlock/maintenance,
/obj/machinery/atmospherics/pipe/smart/simple/orange/hidden{
	dir = 1
	},
/obj/effect/mapping_helpers/airlock/access/all/engineering/general,
/obj/effect/landmark/keep/duct,
/turf/open/floor/plating,
/area/station/maintenance/department/engine)
"qx" = (
/obj/machinery/airalarm/directional/south,
/obj/effect/landmark/keep/lightning,
/turf/open/floor/carpet/black,
/area/station/engineering/singularity/room)
"rn" = (
/obj/machinery/power/energy_accumulator/tesla_coil,
/turf/open/floor/iron/dark,
/area/station/engineering/singularity/room)
"rs" = (
/obj/structure/cable,
/obj/machinery/particle_accelerator/fuel_chamber{
	dir = 4;
	anchored = 1;
	construction_state = 3
	},
/obj/machinery/atmospherics/pipe/smart/manifold4w/supply/hidden/layer4,
/obj/machinery/atmospherics/pipe/smart/manifold4w/scrubbers/hidden/layer2,
/turf/open/floor/plating,
/area/station/engineering/singularity/room)
"se" = (
/obj/machinery/power/energy_accumulator/rad_collector,
/turf/open/floor/iron/dark,
/area/station/engineering/singularity/room)
"sk" = (
/obj/machinery/door/firedoor,
/obj/machinery/door/airlock/engineering/glass{
	name = "Supermatter Engine Room"
	},
/obj/effect/mapping_helpers/airlock/access/all/engineering/general,
/turf/open/floor/plating,
/area/station/engineering/supermatter/room)
"sB" = (
/obj/structure/cable,
/obj/machinery/atmospherics/pipe/smart/manifold4w/supply/hidden/layer4,
/obj/machinery/atmospherics/pipe/smart/manifold4w/scrubbers/hidden/layer2,
/turf/open/floor/iron/dark,
/area/station/engineering/singularity/room)
"tg" = (
/obj/effect/turf_decal/stripes/line{
	dir = 4
	},
/obj/machinery/particle_accelerator/particle_emitter{
	dir = 4;
	anchored = 1;
	construction_state = 3
	},
/turf/open/floor/plating,
/area/station/engineering/singularity/room)
"tr" = (
/obj/machinery/atmospherics/components/unary/vent_pump/on/layer4{
	dir = 4
	},
/turf/open/floor/carpet/black,
/area/station/engineering/singularity/room)
"tt" = (
/obj/machinery/power/energy_accumulator/tesla_coil,
/obj/structure/cable,
/obj/machinery/atmospherics/pipe/smart/manifold4w/scrubbers/hidden/layer2,
/turf/open/floor/iron/dark,
/area/station/engineering/singularity/room)
"tE" = (
/obj/effect/turf_decal/stripes/line,
/obj/effect/landmark/keep/lightning,
/turf/open/floor/iron,
/area/station/engineering/singularity/room)
"ul" = (
/turf/open/space/basic,
/area/template_noop)
"ut" = (
/obj/effect/turf_decal/stripes/line{
	dir = 5
	},
/obj/machinery/particle_accelerator/particle_emitter/right{
	anchored = 1;
	construction_state = 3;
	dir = 4
	},
/turf/open/floor/plating,
/area/station/engineering/singularity/room)
"uU" = (
/obj/machinery/power/energy_accumulator/grounding_rod,
/obj/structure/cable,
/obj/machinery/atmospherics/pipe/smart/manifold4w/scrubbers/hidden/layer2,
/turf/open/floor/iron/dark,
/area/station/engineering/singularity/room)
"vd" = (
/obj/structure/lattice/catwalk,
/obj/machinery/camera/emp_proof/directional/west{
	dir = 4
	},
/turf/open/space/basic,
/area/space/nearstation)
"vB" = (
/obj/effect/turf_decal/bot_red,
/turf/open/floor/plating/airless,
/area/space/nearstation)
"vI" = (
/obj/structure/chair/sofa/corp/left,
/turf/open/floor/carpet/black,
/area/station/engineering/singularity/room)
"vM" = (
/obj/effect/turf_decal/stripes/line{
	dir = 1
	},
/obj/item/radio/intercom/directional/north,
/turf/open/floor/iron,
/area/station/engineering/singularity/room)
"vY" = (
/obj/effect/spawner/random/maintenance,
/obj/structure/reagent_dispensers/fueltank,
/obj/structure/window/reinforced/spawner/directional/west,
/turf/open/floor/plating,
/area/station/maintenance/department/engine)
"wm" = (
/turf/open/floor/plating/airless,
/area/space/nearstation)
"wE" = (
/obj/structure/table/reinforced,
/obj/item/flashlight/lamp,
/turf/open/floor/carpet/black,
/area/station/engineering/singularity/room)
"xy" = (
/obj/structure/cable,
/obj/machinery/power/emitter{
	dir = 4
	},
/turf/open/floor/plating/airless,
/area/space/nearstation)
"xA" = (
/obj/machinery/door/airlock/external,
/obj/effect/mapping_helpers/airlock/access/all/engineering/general,
/obj/effect/mapping_helpers/airlock/cyclelink_helper{
	dir = 8
	},
/obj/structure/fans/tiny,
/turf/open/floor/plating,
/area/station/engineering/singularity/room)
"yn" = (
/obj/structure/cable,
/obj/machinery/door/airlock/engineering/glass{
	name = "Space Engine Room"
	},
/obj/effect/mapping_helpers/airlock/access/all/engineering/general,
/obj/machinery/atmospherics/pipe/smart/manifold4w/supply/hidden/layer4,
/obj/machinery/atmospherics/pipe/smart/manifold4w/scrubbers/hidden/layer2,
/turf/open/floor/iron/dark,
/area/station/engineering/singularity/room)
"yE" = (
/obj/effect/spawner/random/structure/closet_maintenance,
/obj/effect/spawner/random/maintenance,
/turf/open/floor/plating,
/area/station/maintenance/department/engine)
"yP" = (
/obj/structure/sign/warning/secure_area,
/turf/closed/wall/r_wall,
/area/station/engineering/singularity/room)
"yT" = (
/obj/structure/chair/comfy/black{
	dir = 4
	},
/obj/structure/cable,
/obj/machinery/atmospherics/pipe/smart/manifold4w/supply/hidden/layer4,
/obj/machinery/atmospherics/pipe/smart/manifold4w/scrubbers/hidden/layer2,
/turf/open/floor/carpet/black,
/area/station/engineering/singularity/room)
"zA" = (
/obj/structure/cable,
/obj/effect/turf_decal/bot_white/right,
/turf/open/floor/plating/airless,
/area/space/nearstation)
"zC" = (
/turf/open/floor/iron/dark,
/area/station/engineering/singularity/room)
"zE" = (
/obj/effect/landmark/keep/plumbing,
/turf/open/floor/plating,
/area/station/maintenance/department/engine)
"zV" = (
/obj/effect/spawner/structure/window/reinforced,
/turf/open/floor/plating,
/area/station/maintenance/department/engine)
"An" = (
/obj/structure/lattice/catwalk,
/turf/open/space/basic,
/area/space/nearstation)
"AC" = (
/obj/effect/spawner/random/trash/garbage{
	spawn_scatter_radius = 1
	},
/turf/open/floor/plating,
/area/station/maintenance/department/engine)
"AG" = (
/obj/machinery/light/directional/south,
/turf/open/floor/iron/dark,
/area/station/engineering/singularity/room)
"AZ" = (
/obj/item/kirbyplants/random,
/obj/machinery/camera/emp_proof/directional/north{
	c_tag = "Singularity Engine #1"
	},
/turf/open/floor/carpet/black,
/area/station/engineering/singularity/room)
"Bc" = (
/obj/structure/grille,
/turf/open/space/basic,
/area/space/nearstation)
"Bo" = (
/obj/effect/turf_decal/stripes/line{
	dir = 6
	},
/obj/machinery/particle_accelerator/particle_emitter/left{
	anchored = 1;
	construction_state = 3;
	dir = 4
	},
/turf/open/floor/plating,
/area/station/engineering/singularity/room)
"Bx" = (
/obj/structure/chair/sofa/corp,
/turf/open/floor/carpet/black,
/area/station/engineering/singularity/room)
"BH" = (
/obj/machinery/door/airlock/external,
/obj/effect/mapping_helpers/airlock/access/all/engineering/general,
/obj/effect/mapping_helpers/airlock/cyclelink_helper{
	dir = 4
	},
/turf/open/floor/plating,
/area/station/engineering/singularity/room)
"BM" = (
/obj/structure/cable,
/obj/machinery/power/terminal{
	dir = 4
	},
/obj/machinery/atmospherics/pipe/smart/manifold4w/supply/hidden/layer4,
/obj/machinery/atmospherics/pipe/smart/manifold4w/scrubbers/hidden/layer2,
/turf/open/floor/iron/dark,
/area/station/engineering/singularity/room)
"Df" = (
/obj/structure/cable,
/obj/structure/cable/layer1,
/turf/open/floor/iron/dark,
/area/station/engineering/singularity/room)
"Dk" = (
/obj/structure/cable,
/obj/machinery/atmospherics/components/unary/vent_scrubber/on/layer2{
	dir = 4
	},
/turf/open/floor/carpet/black,
/area/station/engineering/singularity/room)
"DK" = (
/obj/structure/sign/warning/vacuum/external/directional/south,
/turf/open/floor/plating,
/area/station/engineering/singularity/room)
"Eb" = (
/obj/machinery/atmospherics/components/unary/vent_pump/on/layer4{
	dir = 4
	},
/turf/open/floor/iron/dark,
/area/station/engineering/singularity/room)
"EM" = (
/obj/structure/lattice/catwalk,
/obj/structure/cable/layer1,
/turf/open/space/basic,
/area/space/nearstation)
"EP" = (
/obj/structure/cable,
/obj/machinery/power/emitter{
	dir = 1
	},
/turf/open/floor/plating/airless,
/area/space/nearstation)
"Fa" = (
/obj/effect/turf_decal/stripes/line{
	dir = 9
	},
/turf/open/floor/plating,
/area/station/engineering/singularity/room)
"Fs" = (
/obj/structure/cable,
/obj/machinery/atmospherics/pipe/smart/manifold4w/scrubbers/hidden/layer2,
/turf/open/floor/carpet/black,
/area/station/engineering/singularity/room)
"Fw" = (
/obj/effect/turf_decal/stripes/line{
	dir = 1
	},
/turf/open/floor/plating,
/area/station/engineering/singularity/room)
"FN" = (
/obj/effect/turf_decal/stripes/line{
	dir = 8
	},
/obj/machinery/particle_accelerator/end_cap{
	anchored = 1;
	construction_state = 3;
	dir = 4
	},
/turf/open/floor/plating,
/area/station/engineering/singularity/room)
"Gs" = (
/obj/machinery/light/directional/north,
/turf/open/floor/iron/dark,
/area/station/engineering/singularity/room)
"GG" = (
/obj/structure/cable,
/obj/machinery/power/emitter,
/turf/open/floor/plating/airless,
/area/space/nearstation)
"GT" = (
/obj/effect/turf_decal/bot{
	dir = 1
	},
/turf/open/floor/plating/airless,
/area/space/nearstation)
"HA" = (
/turf/closed/wall,
/area/station/maintenance/department/engine)
"Jc" = (
/obj/structure/cable,
/obj/structure/cable/layer1,
/obj/machinery/light/directional/north,
/turf/open/floor/plating,
/area/station/engineering/singularity/room)
"Jm" = (
/obj/item/radio/intercom/directional/north,
/obj/structure/tank_dispenser,
/turf/open/floor/iron/dark,
/area/station/engineering/singularity/room)
"JD" = (
/obj/machinery/door/firedoor,
/obj/machinery/door/airlock/engineering/glass{
	name = "Supermatter Engine Room"
	},
/obj/effect/mapping_helpers/airlock/access/all/engineering/general,
/obj/machinery/atmospherics/pipe/smart/manifold4w/scrubbers/hidden/layer2,
/turf/open/floor/iron,
/area/station/engineering/singularity/room)
"JG" = (
/obj/machinery/light/directional/north,
/turf/open/floor/plating,
/area/station/engineering/singularity/room)
"JI" = (
/obj/machinery/door/airlock/external,
/obj/effect/mapping_helpers/airlock/access/all/engineering/general,
/obj/effect/mapping_helpers/airlock/cyclelink_helper{
	dir = 8
	},
/obj/structure/fans/tiny,
/obj/structure/cable,
/obj/structure/cable/layer1,
/turf/open/floor/plating,
/area/station/engineering/singularity/room)
"JT" = (
/obj/effect/landmark/keep/duct,
/turf/open/floor/plating,
/area/station/maintenance/department/engine)
"JY" = (
/obj/machinery/atmospherics/components/unary/vent_scrubber/on/layer2{
	dir = 1
	},
/obj/effect/landmark/keep/lightning,
/turf/open/floor/iron/dark,
/area/station/engineering/singularity/room)
"Ki" = (
/obj/structure/lattice/catwalk,
/obj/structure/cable,
/obj/structure/cable/layer1,
/obj/structure/cable/layer1,
/turf/open/space/basic,
/area/space/nearstation)
"KS" = (
/turf/open/space/basic,
/area/space/nearstation)
"ML" = (
/obj/effect/turf_decal/bot{
	dir = 1
	},
/obj/machinery/field/generator,
/turf/open/floor/plating/airless,
/area/space/nearstation)
"MO" = (
/obj/machinery/door/firedoor,
/obj/machinery/door/airlock/engineering/glass{
	name = "Supermatter Engine Room"
	},
/obj/effect/mapping_helpers/airlock/access/all/engineering/general,
/turf/open/floor/iron/dark,
/area/station/engineering/singularity/room)
"MT" = (
/turf/closed/wall/r_wall,
/area/station/engineering/singularity/room)
"Nh" = (
/obj/effect/turf_decal/stripes/line,
/obj/machinery/atmospherics/pipe/smart/manifold4w/supply/hidden/layer4,
/turf/open/floor/iron,
/area/station/engineering/singularity/room)
"Nv" = (
/obj/structure/cable,
/obj/effect/turf_decal/stripes/line,
/obj/machinery/particle_accelerator/control_box{
	anchored = 1;
	construction_state = 3
	},
/obj/machinery/atmospherics/pipe/smart/manifold4w/supply/hidden/layer4,
/obj/machinery/atmospherics/pipe/smart/manifold4w/scrubbers/hidden/layer2,
/turf/open/floor/plating,
/area/station/engineering/singularity/room)
"NA" = (
/obj/machinery/particle_accelerator/power_box{
	anchored = 1;
	construction_state = 3;
	dir = 4
	},
/turf/open/floor/plating,
/area/station/engineering/singularity/room)
"NP" = (
/obj/effect/turf_decal/stripes/line{
	dir = 1
	},
/obj/structure/cable,
/turf/open/floor/iron,
/area/station/engineering/singularity/room)
"NU" = (
/obj/structure/cable,
/obj/structure/cable/layer1,
/turf/open/floor/plating/airless,
/area/space/nearstation)
"Oh" = (
/obj/effect/turf_decal/stripes/line,
/obj/structure/cable/layer1,
/turf/open/floor/iron,
/area/station/engineering/singularity/room)
"OU" = (
/obj/effect/turf_decal/stripes/line{
	dir = 1
	},
/obj/structure/cable,
/obj/machinery/power/smes/engineering,
/turf/open/floor/iron,
/area/station/engineering/singularity/room)
"OV" = (
/obj/effect/turf_decal/stripes/line{
	dir = 10
	},
/turf/open/floor/plating,
/area/station/engineering/singularity/room)
"PF" = (
/obj/effect/turf_decal/stripes/line,
/obj/machinery/firealarm/directional/south,
/obj/machinery/atmospherics/components/unary/vent_scrubber/on/layer2{
	dir = 1
	},
/turf/open/floor/iron,
/area/station/engineering/singularity/room)
"Qn" = (
/obj/machinery/power/apc/auto_name/directional/south,
/obj/structure/cable,
/turf/open/floor/carpet/black,
/area/station/engineering/singularity/room)
"QX" = (
/obj/structure/lattice/catwalk,
/obj/structure/cable,
/obj/machinery/camera/emp_proof/directional/west{
	dir = 4
	},
/turf/open/space/basic,
/area/space/nearstation)
"Rw" = (
/obj/machinery/camera/emp_proof/directional/west{
	c_tag = "Singularity Engine #4"
	},
/turf/open/floor/plating/airless,
/area/space/nearstation)
"Sh" = (
/obj/effect/turf_decal/stripes/line,
/turf/open/floor/plating,
/area/station/engineering/singularity/room)
"Sj" = (
/obj/effect/turf_decal/stripes/line,
/obj/structure/cable/multilayer/connected,
/turf/open/floor/iron,
/area/station/engineering/singularity/room)
"SK" = (
/obj/structure/table/reinforced,
/obj/item/paper,
/obj/item/pen,
/turf/open/floor/carpet/black,
/area/station/engineering/singularity/room)
"SO" = (
/obj/machinery/door/firedoor,
/obj/structure/cable,
/obj/machinery/door/airlock/engineering/glass{
	name = "Supermatter Engine Room"
	},
/obj/effect/mapping_helpers/airlock/access/all/engineering/general,
/obj/machinery/atmospherics/pipe/smart/manifold4w/supply/hidden/layer4,
/obj/machinery/atmospherics/pipe/smart/manifold4w/scrubbers/hidden/layer2,
/turf/open/floor/iron/dark,
/area/station/engineering/singularity/room)
"SS" = (
/turf/open/floor/plating,
/area/station/engineering/singularity/room)
"Tj" = (
/obj/structure/sign/warning/no_smoking,
/turf/closed/wall/r_wall,
/area/station/engineering/singularity/room)
"TP" = (
/obj/effect/turf_decal/stripes/line{
	dir = 1
	},
/turf/open/floor/plating,
/area/station/maintenance/department/engine)
"UU" = (
/obj/machinery/camera/emp_proof/directional/east{
	c_tag = "Singularity Engine #3"
	},
/obj/machinery/atmospherics/components/unary/vent_pump/on/layer4,
/turf/open/floor/iron/dark,
/area/station/engineering/singularity/room)
"Vm" = (
/turf/open/floor/plating,
/area/station/maintenance/department/engine)
"Vn" = (
/obj/machinery/camera/emp_proof/directional/north{
	c_tag = "Singularity Engine #2"
	},
/obj/item/radio/intercom/directional/north,
/turf/open/floor/iron/dark,
/area/station/engineering/singularity/room)
"Wj" = (
/obj/structure/cable,
/obj/machinery/atmospherics/pipe/smart/manifold4w/scrubbers/hidden/layer2,
/turf/open/floor/iron/dark,
/area/station/engineering/singularity/room)
"XE" = (
/obj/machinery/door/firedoor,
/obj/structure/cable,
/obj/machinery/door/airlock/engineering/glass{
	name = "Supermatter Engine Room"
	},
/obj/effect/mapping_helpers/airlock/access/all/engineering/general,
/obj/machinery/atmospherics/pipe/smart/manifold4w/scrubbers/hidden/layer2,
/turf/open/floor/iron/dark,
/area/station/engineering/singularity/room)
"XP" = (
/obj/effect/turf_decal/stripes/line,
/obj/structure/cable,
/turf/open/floor/iron,
/area/station/engineering/singularity/room)
"XZ" = (
/turf/closed/wall/r_wall,
/area/station/maintenance/department/engine)
"Yq" = (
/obj/structure/cable,
/obj/structure/lattice/catwalk,
/obj/structure/cable/layer1,
/turf/open/space/basic,
/area/space/nearstation)

(1,1,1) = {"
je
je
je
je
MT
kO
JD
kO
yP
MT
kO
ll
kO
Tj
yP
kO
oj
mz
MT
je
je
je
je
je
je
"}
(2,1,1) = {"
je
je
je
je
MT
dx
aP
hn
MT
ch
eg
lM
eg
qx
MT
dx
gk
Nh
MT
je
je
je
je
je
je
"}
(3,1,1) = {"
je
je
je
je
kO
dx
aX
eT
kO
Bx
eg
Dk
tr
eg
kO
dx
zC
Nh
MT
je
je
je
je
je
je
"}
(4,1,1) = {"
je
je
je
je
kO
dx
aX
hn
kO
vI
eg
Fs
yT
nx
ck
dD
sB
Nh
MT
je
je
je
je
je
je
"}
(5,1,1) = {"
MT
XE
MT
kO
MT
lP
aX
hn
MT
AZ
wE
oW
SK
Qn
MT
dx
sB
PF
MT
je
je
je
je
je
je
"}
(6,1,1) = {"
Jm
Wj
JY
zC
MO
zC
aX
hn
MT
kO
kO
kO
kO
kO
MT
dx
sB
hn
XZ
HA
HA
HA
HA
HA
XZ
"}
(7,1,1) = {"
rn
uU
se
se
kO
dx
aX
hn
MT
Gs
zC
zC
zC
AG
MT
vM
sB
hn
XZ
pi
kc
eS
ah
eP
qo
"}
(8,1,1) = {"
rn
tt
se
se
kO
dx
aX
hn
MT
zC
Fa
FN
OV
Eb
MT
dx
sB
zC
sk
TP
Vm
AC
JT
vY
XZ
"}
(9,1,1) = {"
rn
uU
se
se
kO
dx
mC
sB
yn
sB
af
rs
Nv
sB
yn
sB
sB
tE
XZ
XZ
zV
zV
zE
yE
XZ
"}
(10,1,1) = {"
UU
np
gQ
sB
SO
BM
mC
XP
MT
aP
Fw
NA
Sh
zC
MT
dx
zC
hn
kO
ul
ul
je
je
je
je
"}
(11,1,1) = {"
MT
MT
MT
kO
MT
OU
zC
Sj
MT
Vn
ut
tg
Bo
zC
MT
dx
zC
hn
kO
ul
ul
ul
ul
ul
je
"}
(12,1,1) = {"
je
je
je
ul
kO
NP
Df
Oh
MT
Gs
zC
zC
zC
AG
MT
dx
zC
hn
kO
ul
ul
ul
ul
ul
je
"}
(13,1,1) = {"
je
je
je
je
MT
kO
ok
kO
MT
kO
kO
kO
kO
kO
MT
kO
BH
kO
MT
ul
ul
ul
ul
ul
je
"}
(14,1,1) = {"
je
je
je
je
MT
JG
Jc
DK
MT
An
An
nM
An
An
MT
SS
SS
cP
MT
ul
ul
ul
ul
ul
je
"}
(15,1,1) = {"
je
je
je
je
MT
kO
JI
kO
MT
An
nM
nM
nM
nM
MT
kO
xA
kO
MT
ul
ul
ul
ul
ul
je
"}
(16,1,1) = {"
je
je
je
je
An
An
Ki
nM
Rw
nM
nM
An
nM
KS
Bc
An
An
nM
eH
ul
ul
ul
ul
ul
je
"}
(17,1,1) = {"
je
je
je
je
Bc
An
ol
An
nM
nM
nM
nM
An
nM
nM
nM
An
An
Bc
ul
ul
ul
ul
ul
je
"}
(18,1,1) = {"
je
je
je
je
bM
An
ol
An
An
nM
An
nM
An
nM
nM
An
An
KS
bM
ul
ul
ul
ul
ul
je
"}
(19,1,1) = {"
je
je
je
je
An
hW
ol
ol
Yq
Yq
Yq
Yq
Yq
Yq
Yq
EM
EM
An
An
ul
ul
ul
ul
ul
je
"}
(20,1,1) = {"
je
je
je
je
An
hW
EM
An
xy
An
wm
wm
KS
An
xy
An
EM
nM
An
je
je
je
je
je
je
"}
(21,1,1) = {"
je
je
je
je
Bc
hW
EM
wm
ML
wm
nM
nM
nM
wm
ML
wm
EM
nM
Bc
je
je
je
je
je
je
"}
(22,1,1) = {"
je
je
je
je
bM
hW
EM
An
wm
GT
wm
nM
wm
GT
wm
An
EM
An
bM
je
je
je
je
je
je
"}
(23,1,1) = {"
je
je
je
je
bM
hW
EM
zA
wm
wm
nM
nM
nM
wm
wm
dT
EM
An
bM
je
je
je
je
je
je
"}
(24,1,1) = {"
je
je
je
je
Bc
hW
EM
NU
bp
nM
nM
vB
nM
nM
bp
NU
EM
nM
Bc
je
je
je
je
je
je
"}
(25,1,1) = {"
je
je
je
je
bM
hW
An
dT
wm
wm
nM
nM
nM
wm
wm
zA
An
nM
bM
je
je
je
je
je
je
"}
(26,1,1) = {"
je
je
je
je
bM
hW
An
An
wm
GT
wm
nM
wm
GT
wm
An
An
An
bM
je
je
je
je
je
je
"}
(27,1,1) = {"
je
je
je
je
Bc
hW
hW
GG
ML
wm
nM
nM
nM
wm
ML
EP
An
nM
Bc
je
je
je
je
je
je
"}
(28,1,1) = {"
je
je
je
je
An
hW
An
An
wm
An
wm
wm
wm
An
wm
hW
An
nM
An
je
je
je
je
je
je
"}
(29,1,1) = {"
je
je
je
je
bM
hW
QX
hW
hW
hW
hW
hW
hW
hW
hW
hW
vd
An
bM
je
je
je
je
je
je
"}
(30,1,1) = {"
je
je
je
je
bM
An
bM
An
Bc
Bc
Bc
Bc
Bc
Bc
Bc
An
bM
KS
bM
je
je
je
je
je
je
"}
(31,1,1) = {"
je
je
je
je
je
je
je
je
je
je
je
je
je
je
je
je
je
je
je
je
je
je
je
je
je
"}
(32,1,1) = {"
je
je
je
je
je
je
je
je
je
je
je
je
je
je
je
je
je
je
je
je
je
je
je
je
je
"}
(33,1,1) = {"
je
je
je
je
je
je
je
je
je
je
je
je
je
je
je
je
je
je
je
je
je
je
je
je
je
"}
