//MAP CONVERTED BY dmm2tgm.py THIS HEADER COMMENT PREVENTS RECONVERSION, DO NOT REMOVE
"af" = (
/obj/structure/cable,
/obj/effect/turf_decal/stripes/line{
	dir = 1
	},
/obj/machinery/atmospherics/pipe/smart/manifold4w/supply/hidden/layer4,
/obj/machinery/atmospherics/pipe/smart/manifold4w/scrubbers/hidden/layer2,
/turf/open/floor/plating,
/area/station/engineering/supermatter/room)
"bp" = (
/obj/structure/cable/multilayer/connected,
/turf/open/floor/plating/airless,
/area/space/nearstation)
"bM" = (
/turf/closed/wall/r_wall,
/area/space/nearstation)
"ch" = (
/obj/structure/chair/sofa/corp/right,
/obj/machinery/light/directional/west,
/turf/open/floor/carpet/black,
/area/station/engineering/supermatter/room)
"ck" = (
/obj/effect/spawner/structure/window/reinforced/plasma,
/obj/structure/cable,
/obj/machinery/atmospherics/pipe/smart/manifold4w/supply/hidden/layer4,
/obj/machinery/atmospherics/pipe/smart/manifold4w/scrubbers/hidden/layer2,
/turf/open/floor/plating,
/area/station/engineering/supermatter/room)
"cP" = (
/obj/machinery/light/directional/south,
/obj/structure/sign/warning/vacuum/external/directional/south,
/turf/open/floor/plating,
/area/station/engineering/supermatter/room)
"cT" = (
/obj/effect/turf_decal/stripes/line,
/obj/machinery/atmospherics/components/unary/vent_pump/on/layer4{
	dir = 1
	},
/turf/open/floor/iron,
/area/station/engineering/supermatter/room)
"dc" = (
/obj/machinery/atmospherics/components/unary/vent_scrubber/on/layer2{
	dir = 8
	},
/turf/open/floor/iron/dark,
/area/station/engineering/supermatter/room)
"dx" = (
/obj/effect/turf_decal/stripes/line{
	dir = 1
	},
/turf/open/floor/iron,
/area/station/engineering/supermatter/room)
"dT" = (
/obj/structure/cable,
/obj/effect/turf_decal/bot_white/left,
/turf/open/floor/plating/airless,
/area/space/nearstation)
"eg" = (
/turf/open/floor/carpet/black,
/area/station/engineering/supermatter/room)
"eH" = (
/obj/structure/lattice/catwalk,
/obj/machinery/camera/emp_proof/directional/west{
	c_tag = "Singularity Engine #4"
	},
/turf/open/space/basic,
/area/space/nearstation)
"gQ" = (
/obj/machinery/the_singularitygen,
/obj/structure/cable,
/obj/machinery/atmospherics/pipe/smart/manifold4w/scrubbers/hidden/layer2,
/turf/open/floor/iron/dark,
/area/station/engineering/supermatter/room)
"hn" = (
/obj/effect/turf_decal/stripes/line,
/turf/open/floor/iron,
/area/station/engineering/supermatter/room)
"hW" = (
/obj/structure/lattice/catwalk,
/obj/structure/cable,
/turf/open/space/basic,
/area/space/nearstation)
"iY" = (
/obj/machinery/atmospherics/pipe/smart/manifold4w/supply/hidden/layer4,
/turf/open/floor/iron/dark,
/area/station/engineering/supermatter/room)
"je" = (
/turf/template_noop,
/area/template_noop)
"kO" = (
/obj/effect/spawner/structure/window/reinforced/plasma,
/turf/open/floor/plating,
/area/station/engineering/supermatter/room)
"ll" = (
/obj/machinery/door/firedoor,
/obj/structure/cable,
/obj/machinery/door/airlock/engineering/glass{
	name = "Supermatter Engine Room"
	},
/obj/effect/mapping_helpers/airlock/access/all/engineering/general,
/turf/open/floor/iron,
/area/station/engineering/supermatter/room)
"lM" = (
/obj/structure/cable,
/turf/open/floor/carpet/black,
/area/station/engineering/supermatter/room)
"np" = (
/obj/machinery/the_singularitygen/tesla,
/obj/structure/cable,
/obj/machinery/atmospherics/pipe/smart/manifold4w/scrubbers/hidden/layer2,
/turf/open/floor/iron/dark,
/area/station/engineering/supermatter/room)
"nD" = (
/obj/machinery/door/firedoor,
/obj/structure/cable,
/obj/machinery/door/airlock/engineering/glass{
	name = "Supermatter Engine Room"
	},
/obj/effect/mapping_helpers/airlock/access/all/engineering/general,
/obj/machinery/atmospherics/pipe/smart/manifold4w/scrubbers/hidden/layer2,
/obj/machinery/atmospherics/pipe/smart/manifold4w/supply/hidden/layer4,
/turf/open/floor/iron/dark,
/area/station/engineering/supermatter/room)
"nM" = (
/obj/structure/lattice,
/turf/open/space/basic,
/area/space/nearstation)
"oj" = (
/obj/machinery/door/firedoor,
/obj/machinery/door/airlock/engineering/glass{
	name = "Supermatter Engine Room"
	},
/obj/effect/mapping_helpers/airlock/access/all/engineering/general,
/turf/open/floor/iron,
/area/station/engineering/supermatter/room)
"ok" = (
/obj/machinery/door/airlock/external,
/obj/effect/mapping_helpers/airlock/access/all/engineering/general,
/obj/effect/mapping_helpers/airlock/cyclelink_helper{
	dir = 4
	},
/obj/structure/cable,
/obj/structure/cable/layer1,
/turf/open/floor/plating,
/area/station/engineering/supermatter/room)
"ol" = (
/obj/structure/lattice/catwalk,
/obj/structure/cable,
/obj/structure/cable/layer1,
/turf/open/space/basic,
/area/space/nearstation)
"oW" = (
/obj/structure/table/reinforced,
/turf/open/floor/carpet/black,
/area/station/engineering/supermatter/room)
"pB" = (
/obj/structure/cable,
/obj/machinery/atmospherics/pipe/smart/manifold4w/supply/hidden/layer4,
/obj/machinery/atmospherics/pipe/smart/manifold4w/scrubbers/hidden/layer2,
/turf/open/floor/carpet/black,
/area/station/engineering/supermatter/room)
"qa" = (
/obj/effect/spawner/structure/window/reinforced/plasma,
/obj/machinery/atmospherics/pipe/smart/manifold4w/supply/hidden/layer4,
/turf/open/floor/plating,
/area/station/engineering/supermatter/room)
"qx" = (
/obj/machinery/light/directional/west,
/obj/machinery/airalarm/directional/south,
/turf/open/floor/carpet/black,
/area/station/engineering/supermatter/room)
"rn" = (
/obj/machinery/power/energy_accumulator/tesla_coil,
/turf/open/floor/iron/dark,
/area/station/engineering/supermatter/room)
"rs" = (
/obj/structure/cable,
/obj/machinery/particle_accelerator/fuel_chamber{
	dir = 4;
	anchored = 1;
	construction_state = 3
	},
/obj/machinery/atmospherics/pipe/smart/manifold4w/supply/hidden/layer4,
/obj/machinery/atmospherics/pipe/smart/manifold4w/scrubbers/hidden/layer2,
/turf/open/floor/plating,
/area/station/engineering/supermatter/room)
"se" = (
/obj/machinery/power/energy_accumulator/rad_collector/anchored,
/obj/machinery/power/energy_accumulator/rad_collector/anchored,
/turf/open/floor/iron/dark,
/area/station/engineering/supermatter/room)
"sk" = (
/obj/machinery/door/firedoor,
/obj/machinery/door/airlock/engineering/glass{
	name = "Supermatter Engine Room"
	},
/obj/effect/mapping_helpers/airlock/access/all/engineering/general,
/turf/open/floor/plating,
/area/station/engineering/supermatter/room)
"sB" = (
/obj/structure/cable,
/obj/machinery/atmospherics/pipe/smart/manifold4w/scrubbers/hidden/layer2,
/obj/machinery/atmospherics/components/unary/vent_pump/on/layer4{
	dir = 8
	},
/turf/open/floor/iron/dark,
/area/station/engineering/supermatter/room)
"tg" = (
/obj/effect/turf_decal/stripes/line{
	dir = 4
	},
/obj/machinery/particle_accelerator/particle_emitter/center{
	anchored = 1;
	construction_state = 3;
	dir = 4
	},
/turf/open/floor/plating,
/area/station/engineering/supermatter/room)
"tt" = (
/obj/machinery/power/energy_accumulator/tesla_coil,
/obj/structure/cable,
/obj/machinery/atmospherics/pipe/smart/manifold4w/scrubbers/hidden/layer2,
/turf/open/floor/iron/dark,
/area/station/engineering/supermatter/room)
"ut" = (
/obj/effect/turf_decal/stripes/line{
	dir = 5
	},
/obj/machinery/particle_accelerator/particle_emitter/right{
	anchored = 1;
	construction_state = 3;
	dir = 4
	},
/turf/open/floor/plating,
/area/station/engineering/supermatter/room)
"uU" = (
/obj/machinery/power/energy_accumulator/grounding_rod,
/obj/structure/cable,
/obj/machinery/atmospherics/pipe/smart/manifold4w/scrubbers/hidden/layer2,
/turf/open/floor/iron/dark,
/area/station/engineering/supermatter/room)
"vd" = (
/obj/structure/lattice/catwalk,
/obj/machinery/camera/emp_proof/directional/west{
	dir = 4
	},
/turf/open/space/basic,
/area/space/nearstation)
"vB" = (
/obj/effect/turf_decal/bot_red,
/turf/open/floor/plating/airless,
/area/space/nearstation)
"vI" = (
/obj/structure/chair/sofa/corp/left,
/turf/open/floor/carpet/black,
/area/station/engineering/supermatter/room)
"vM" = (
/obj/effect/turf_decal/stripes/line{
	dir = 1
	},
/obj/machinery/light/directional/north,
/turf/open/floor/iron,
/area/station/engineering/supermatter/room)
"wm" = (
/turf/open/floor/plating/airless,
/area/space/nearstation)
"wo" = (
/obj/machinery/atmospherics/components/unary/vent_scrubber/on/layer2{
	dir = 4
	},
/turf/open/floor/iron/dark,
/area/station/engineering/supermatter/room)
"wE" = (
/obj/structure/table/reinforced,
/obj/item/flashlight/lamp,
/turf/open/floor/carpet/black,
/area/station/engineering/supermatter/room)
"xk" = (
/obj/machinery/door/firedoor,
/obj/machinery/door/airlock/engineering/glass{
	name = "Supermatter Engine Room"
	},
/obj/effect/mapping_helpers/airlock/access/all/engineering/general,
/obj/machinery/atmospherics/pipe/smart/manifold4w/scrubbers/hidden/layer2,
/turf/open/floor/iron,
/area/station/engineering/supermatter/room)
"xy" = (
/obj/structure/cable,
/obj/machinery/power/emitter{
	dir = 4
	},
/turf/open/floor/plating/airless,
/area/space/nearstation)
"xA" = (
/obj/machinery/door/airlock/external,
/obj/effect/mapping_helpers/airlock/access/all/engineering/general,
/obj/effect/mapping_helpers/airlock/cyclelink_helper{
	dir = 8
	},
/obj/structure/fans/tiny,
/turf/open/floor/plating,
/area/station/engineering/supermatter/room)
"yn" = (
/obj/structure/cable,
/obj/machinery/door/airlock/engineering/glass{
	name = "Space Engine Room"
	},
/obj/effect/mapping_helpers/airlock/access/all/engineering/general,
/obj/machinery/atmospherics/pipe/smart/manifold4w/supply/hidden/layer4,
/obj/machinery/atmospherics/pipe/smart/manifold4w/scrubbers/hidden/layer2,
/turf/open/floor/iron/dark,
/area/station/engineering/supermatter/room)
"yo" = (
/obj/machinery/door/firedoor,
/obj/structure/cable,
/obj/machinery/door/airlock/engineering/glass{
	name = "Supermatter Engine Room"
	},
/obj/machinery/atmospherics/pipe/smart/manifold4w/scrubbers/hidden/layer2,
/obj/effect/mapping_helpers/airlock/access/all/engineering/general,
/turf/open/floor/iron/dark,
/area/station/engineering/supermatter/room)
"yP" = (
/obj/structure/sign/warning/secure_area,
/turf/closed/wall/r_wall,
/area/station/engineering/supermatter/room)
"yR" = (
/obj/structure/cable,
/obj/machinery/atmospherics/pipe/smart/manifold4w/supply/hidden/layer4,
/obj/machinery/atmospherics/pipe/smart/manifold4w/scrubbers/hidden/layer2,
/turf/open/floor/iron/dark,
/area/station/engineering/supermatter/room)
"yT" = (
/obj/structure/chair/comfy/black{
	dir = 4
	},
/obj/structure/cable,
/obj/machinery/atmospherics/pipe/smart/manifold4w/supply/hidden/layer4,
/obj/machinery/atmospherics/pipe/smart/manifold4w/scrubbers/hidden/layer2,
/turf/open/floor/carpet/black,
/area/station/engineering/supermatter/room)
"zq" = (
/obj/machinery/atmospherics/components/unary/vent_scrubber/on/layer2,
/turf/open/floor/carpet/black,
/area/station/engineering/supermatter/room)
"zA" = (
/obj/structure/cable,
/obj/effect/turf_decal/bot_white/right,
/turf/open/floor/plating/airless,
/area/space/nearstation)
"zC" = (
/turf/open/floor/iron/dark,
/area/station/engineering/supermatter/room)
"An" = (
/obj/structure/lattice/catwalk,
/turf/open/space/basic,
/area/space/nearstation)
"Ay" = (
/obj/effect/turf_decal/stripes/line{
	dir = 1
	},
/obj/structure/cable,
/obj/machinery/atmospherics/pipe/smart/manifold4w/supply/hidden/layer4,
/obj/machinery/atmospherics/pipe/smart/manifold4w/scrubbers/hidden/layer2,
/turf/open/floor/iron,
/area/station/engineering/supermatter/room)
"AG" = (
/obj/machinery/light/directional/south,
/turf/open/floor/iron/dark,
/area/station/engineering/supermatter/room)
"AZ" = (
/obj/item/kirbyplants/random,
/obj/machinery/camera/emp_proof/directional/north{
	c_tag = "Singularity Engine #1"
	},
/turf/open/floor/carpet/black,
/area/station/engineering/supermatter/room)
"Bc" = (
/obj/structure/grille,
/turf/open/space/basic,
/area/space/nearstation)
"Bo" = (
/obj/effect/turf_decal/stripes/line{
	dir = 6
	},
/obj/machinery/particle_accelerator/particle_emitter/left{
	anchored = 1;
	construction_state = 3;
	dir = 4
	},
/turf/open/floor/plating,
/area/station/engineering/supermatter/room)
"Bx" = (
/obj/structure/chair/sofa/corp,
/turf/open/floor/carpet/black,
/area/station/engineering/supermatter/room)
"BH" = (
/obj/machinery/door/airlock/external,
/obj/effect/mapping_helpers/airlock/access/all/engineering/general,
/obj/effect/mapping_helpers/airlock/cyclelink_helper{
	dir = 4
	},
/turf/open/floor/plating,
/area/station/engineering/supermatter/room)
"BM" = (
/obj/structure/cable,
/obj/machinery/power/terminal{
	dir = 4
	},
/obj/machinery/atmospherics/pipe/smart/manifold4w/scrubbers/hidden/layer2,
/turf/open/floor/iron/dark,
/area/station/engineering/supermatter/room)
"Df" = (
/obj/structure/cable,
/obj/structure/cable/layer1,
/turf/open/floor/iron/dark,
/area/station/engineering/supermatter/room)
"DK" = (
/obj/effect/turf_decal/stripes/line,
/obj/machinery/light/directional/south,
/turf/open/floor/iron,
/area/station/engineering/supermatter/room)
"Ew" = (
/obj/machinery/atmospherics/components/unary/vent_pump/on/layer4{
	dir = 8
	},
/turf/open/floor/iron/dark,
/area/station/engineering/supermatter/room)
"EM" = (
/obj/structure/lattice/catwalk,
/obj/structure/cable/layer1,
/turf/open/space/basic,
/area/space/nearstation)
"EP" = (
/obj/structure/cable,
/obj/machinery/power/emitter{
	dir = 1
	},
/turf/open/floor/plating/airless,
/area/space/nearstation)
"Fa" = (
/obj/effect/turf_decal/stripes/line{
	dir = 9
	},
/turf/open/floor/plating,
/area/station/engineering/supermatter/room)
"Fw" = (
/obj/effect/turf_decal/stripes/line{
	dir = 1
	},
/turf/open/floor/plating,
/area/station/engineering/supermatter/room)
"FN" = (
/obj/effect/turf_decal/stripes/line{
	dir = 8
	},
/obj/machinery/particle_accelerator/end_cap{
	anchored = 1;
	construction_state = 3;
	dir = 4
	},
/turf/open/floor/plating,
/area/station/engineering/supermatter/room)
"Gs" = (
/obj/machinery/light/directional/north,
/turf/open/floor/iron/dark,
/area/station/engineering/supermatter/room)
"GG" = (
/obj/structure/cable,
/obj/machinery/power/emitter,
/turf/open/floor/plating/airless,
/area/space/nearstation)
"GM" = (
/obj/machinery/power/energy_accumulator/rad_collector/anchored,
/turf/open/floor/iron/dark,
/area/station/engineering/supermatter/room)
"GT" = (
/obj/effect/turf_decal/bot{
	dir = 1
	},
/turf/open/floor/plating/airless,
/area/space/nearstation)
"Jc" = (
/obj/structure/cable,
/obj/structure/cable/layer1,
/turf/open/floor/plating,
/area/station/engineering/supermatter/room)
"JI" = (
/obj/machinery/door/airlock/external,
/obj/effect/mapping_helpers/airlock/access/all/engineering/general,
/obj/effect/mapping_helpers/airlock/cyclelink_helper{
	dir = 8
	},
/obj/structure/fans/tiny,
/obj/structure/cable,
/obj/structure/cable/layer1,
/turf/open/floor/plating,
/area/station/engineering/supermatter/room)
"JY" = (
/obj/machinery/light/directional/west,
/obj/machinery/atmospherics/components/unary/vent_scrubber/on/layer2{
	dir = 1
	},
/turf/open/floor/iron/dark,
/area/station/engineering/supermatter/room)
"Ki" = (
/obj/structure/lattice/catwalk,
/obj/structure/cable,
/obj/structure/cable/layer1,
/obj/structure/cable/layer1,
/turf/open/space/basic,
/area/space/nearstation)
"KS" = (
/turf/open/space/basic,
/area/space/nearstation)
"Mt" = (
/obj/machinery/atmospherics/components/unary/vent_pump/on/layer4{
	dir = 4
	},
/turf/open/floor/carpet/black,
/area/station/engineering/supermatter/room)
"ML" = (
/obj/effect/turf_decal/bot{
	dir = 1
	},
/obj/machinery/field/generator,
/turf/open/floor/plating/airless,
/area/space/nearstation)
"MO" = (
/obj/machinery/door/firedoor,
/obj/machinery/door/airlock/engineering/glass{
	name = "Supermatter Engine Room"
	},
/obj/effect/mapping_helpers/airlock/access/all/engineering/general,
/turf/open/floor/iron/dark,
/area/station/engineering/supermatter/room)
"MT" = (
/turf/closed/wall/r_wall,
/area/station/engineering/supermatter/room)
"Nv" = (
/obj/structure/cable,
/obj/effect/turf_decal/stripes/line,
/obj/machinery/particle_accelerator/control_box{
	anchored = 1;
	construction_state = 3
	},
/obj/machinery/atmospherics/pipe/smart/manifold4w/supply/hidden/layer4,
/obj/machinery/atmospherics/pipe/smart/manifold4w/scrubbers/hidden/layer2,
/turf/open/floor/plating,
/area/station/engineering/supermatter/room)
"NA" = (
/obj/machinery/particle_accelerator/power_box{
	anchored = 1;
	construction_state = 3;
	dir = 4
	},
/turf/open/floor/plating,
/area/station/engineering/supermatter/room)
"NN" = (
/obj/machinery/atmospherics/pipe/smart/manifold4w/scrubbers/hidden/layer2,
/turf/open/floor/iron/dark,
/area/station/engineering/supermatter/room)
"NP" = (
/obj/effect/turf_decal/stripes/line{
	dir = 1
	},
/obj/structure/cable,
/turf/open/floor/iron,
/area/station/engineering/supermatter/room)
"NU" = (
/obj/structure/cable,
/obj/structure/cable/layer1,
/turf/open/floor/plating/airless,
/area/space/nearstation)
"Oh" = (
/obj/effect/turf_decal/stripes/line,
/obj/structure/cable/layer1,
/turf/open/floor/iron,
/area/station/engineering/supermatter/room)
"OU" = (
/obj/effect/turf_decal/stripes/line{
	dir = 1
	},
/obj/structure/cable,
/obj/machinery/power/smes/engineering,
/turf/open/floor/iron,
/area/station/engineering/supermatter/room)
"OV" = (
/obj/effect/turf_decal/stripes/line{
	dir = 10
	},
/turf/open/floor/plating,
/area/station/engineering/supermatter/room)
"PF" = (
/obj/effect/turf_decal/stripes/line,
/obj/machinery/firealarm/directional/south,
/obj/machinery/atmospherics/components/unary/vent_scrubber/on/layer2{
	dir = 1
	},
/turf/open/floor/iron,
/area/station/engineering/supermatter/room)
"Qn" = (
/obj/machinery/power/apc/auto_name/directional/south,
/obj/structure/cable,
/turf/open/floor/carpet/black,
/area/station/engineering/supermatter/room)
"QX" = (
/obj/structure/lattice/catwalk,
/obj/structure/cable,
/obj/machinery/camera/emp_proof/directional/west{
	dir = 4
	},
/turf/open/space/basic,
/area/space/nearstation)
"Rw" = (
/obj/machinery/camera/emp_proof/directional/west{
	c_tag = "Singularity Engine #4"
	},
/turf/open/floor/plating/airless,
/area/station/engineering/supermatter/room)
"Sh" = (
/obj/effect/turf_decal/stripes/line,
/turf/open/floor/plating,
/area/station/engineering/supermatter/room)
"Sj" = (
/obj/effect/turf_decal/stripes/line,
/obj/structure/cable/multilayer/connected,
/turf/open/floor/iron,
/area/station/engineering/supermatter/room)
"SK" = (
/obj/structure/table/reinforced,
/obj/item/pen/fountain,
/obj/item/paper{
	default_raw_text = "Jim Norton's Quebecois Coffee.         You see, in 2265 the Quebecois had finally had enough of Canada's shit, and went to the one place that wasn't corrupted by Canuckistan.Je vais au seul endroit qui n'a pas ??? corrompu par les Canadiens ... ESPACE.";
	name = "Coffee Shop";
	pixel_x = -4;
	pixel_y = 6
	},
/turf/open/floor/carpet/black,
/area/station/engineering/supermatter/room)
"SS" = (
/turf/open/floor/plating,
/area/station/engineering/supermatter/room)
"Tj" = (
/obj/structure/sign/warning/no_smoking,
/turf/closed/wall/r_wall,
/area/station/engineering/supermatter/room)
"UU" = (
/obj/machinery/camera/emp_proof/directional/east{
	c_tag = "Singularity Engine #3"
	},
/turf/open/floor/iron/dark,
/area/station/engineering/supermatter/room)
"Vn" = (
/obj/machinery/camera/emp_proof/directional/north{
	c_tag = "Singularity Engine #2"
	},
/turf/open/floor/iron/dark,
/area/station/engineering/supermatter/room)
"VO" = (
/obj/effect/turf_decal/stripes/line,
/obj/machinery/atmospherics/pipe/smart/manifold4w/supply/hidden/layer4,
/turf/open/floor/iron,
/area/station/engineering/supermatter/room)
"XP" = (
/obj/effect/turf_decal/stripes/line,
/obj/structure/cable,
/turf/open/floor/iron,
/area/station/engineering/supermatter/room)
"Yf" = (
/obj/structure/cable,
/obj/machinery/atmospherics/pipe/smart/manifold4w/scrubbers/hidden/layer2,
/turf/open/floor/iron/dark,
/area/station/engineering/supermatter/room)
"Yq" = (
/obj/structure/cable,
/obj/structure/lattice/catwalk,
/obj/structure/cable/layer1,
/turf/open/space/basic,
/area/space/nearstation)
"Yz" = (
/obj/machinery/atmospherics/components/unary/vent_pump/on/layer4,
/turf/open/floor/iron/dark,
/area/station/engineering/supermatter/room)
"Zn" = (
/obj/structure/closet/radiation,
/turf/open/floor/carpet/black,
/area/station/engineering/supermatter/room)
"ZC" = (
/obj/structure/cable,
/obj/machinery/atmospherics/pipe/smart/manifold4w/scrubbers/hidden/layer2,
/turf/open/floor/carpet/black,
/area/station/engineering/supermatter/room)

(1,1,1) = {"
je
je
je
je
MT
kO
xk
kO
yP
MT
kO
ll
kO
Tj
yP
kO
oj
qa
MT
je
je
je
je
je
je
"}
(2,1,1) = {"
je
je
je
je
MT
dx
dc
hn
MT
ch
eg
lM
eg
qx
MT
dx
Yz
VO
MT
je
je
je
je
je
je
"}
(3,1,1) = {"
je
je
je
je
kO
dx
zC
hn
kO
Bx
eg
lM
Mt
Zn
kO
dx
zC
VO
MT
je
je
je
je
je
je
"}
(4,1,1) = {"
je
je
je
je
kO
dx
iY
cT
kO
vI
zq
ZC
yT
pB
ck
Ay
yR
VO
MT
je
je
je
je
je
je
"}
(5,1,1) = {"
MT
nD
MT
kO
MT
dx
iY
hn
MT
AZ
wE
oW
SK
Qn
MT
dx
yR
PF
MT
je
je
je
je
je
je
"}
(6,1,1) = {"
zC
sB
JY
zC
MO
zC
iY
hn
MT
kO
kO
kO
kO
kO
MT
dx
yR
hn
MT
je
je
je
je
je
je
"}
(7,1,1) = {"
rn
uU
GM
GM
kO
dx
iY
DK
MT
Gs
zC
zC
zC
AG
MT
vM
yR
hn
MT
je
je
je
je
je
je
"}
(8,1,1) = {"
rn
tt
GM
GM
kO
dx
iY
hn
MT
wo
Fa
FN
OV
zC
MT
dx
yR
zC
sk
je
je
je
je
je
je
"}
(9,1,1) = {"
rn
uU
se
GM
kO
NP
yR
yR
yn
yR
af
rs
Nv
yR
yn
yR
yR
hn
MT
je
je
je
je
je
je
"}
(10,1,1) = {"
UU
np
gQ
Yf
yo
BM
NN
XP
MT
zC
Fw
NA
Sh
Ew
MT
dx
zC
hn
kO
je
je
je
je
je
je
"}
(11,1,1) = {"
MT
MT
MT
kO
MT
OU
zC
Sj
MT
Vn
ut
tg
Bo
zC
MT
dx
zC
hn
kO
je
je
je
je
je
je
"}
(12,1,1) = {"
je
je
je
je
kO
NP
Df
Oh
MT
Gs
zC
zC
zC
AG
MT
dx
zC
hn
kO
je
je
je
je
je
je
"}
(13,1,1) = {"
je
je
je
je
MT
kO
ok
kO
MT
kO
kO
kO
kO
kO
MT
kO
BH
kO
MT
je
je
je
je
je
je
"}
(14,1,1) = {"
je
je
je
je
MT
SS
Jc
cP
MT
An
An
nM
An
An
MT
SS
SS
cP
MT
je
je
je
je
je
je
"}
(15,1,1) = {"
je
je
je
je
MT
kO
JI
kO
MT
An
nM
nM
nM
nM
MT
kO
xA
kO
MT
je
je
je
je
je
je
"}
(16,1,1) = {"
je
je
je
je
An
An
Ki
nM
Rw
nM
nM
An
nM
KS
Bc
An
An
nM
eH
je
je
je
je
je
je
"}
(17,1,1) = {"
je
je
je
je
Bc
An
ol
An
nM
nM
nM
nM
An
nM
nM
nM
An
An
Bc
je
je
je
je
je
je
"}
(18,1,1) = {"
je
je
je
je
bM
An
ol
An
An
nM
An
nM
An
nM
nM
An
An
KS
bM
je
je
je
je
je
je
"}
(19,1,1) = {"
je
je
je
je
An
hW
ol
ol
Yq
Yq
Yq
Yq
Yq
Yq
Yq
EM
EM
An
An
je
je
je
je
je
je
"}
(20,1,1) = {"
je
je
je
je
An
hW
EM
An
xy
An
wm
wm
KS
An
xy
An
EM
nM
An
je
je
je
je
je
je
"}
(21,1,1) = {"
je
je
je
je
Bc
hW
EM
wm
ML
wm
nM
nM
nM
wm
ML
wm
EM
nM
Bc
je
je
je
je
je
je
"}
(22,1,1) = {"
je
je
je
je
bM
hW
EM
An
wm
GT
wm
nM
wm
GT
wm
An
EM
An
bM
je
je
je
je
je
je
"}
(23,1,1) = {"
je
je
je
je
bM
hW
EM
zA
wm
wm
nM
nM
nM
wm
wm
dT
EM
An
bM
je
je
je
je
je
je
"}
(24,1,1) = {"
je
je
je
je
Bc
hW
EM
NU
bp
nM
nM
vB
nM
nM
bp
NU
EM
nM
Bc
je
je
je
je
je
je
"}
(25,1,1) = {"
je
je
je
je
bM
hW
An
dT
wm
wm
nM
nM
nM
wm
wm
zA
An
nM
bM
je
je
je
je
je
je
"}
(26,1,1) = {"
je
je
je
je
bM
hW
An
An
wm
GT
wm
nM
wm
GT
wm
An
An
An
bM
je
je
je
je
je
je
"}
(27,1,1) = {"
je
je
je
je
Bc
hW
hW
GG
ML
wm
nM
nM
nM
wm
ML
EP
An
nM
Bc
je
je
je
je
je
je
"}
(28,1,1) = {"
je
je
je
je
An
hW
An
An
wm
An
wm
wm
wm
An
wm
hW
An
nM
An
je
je
je
je
je
je
"}
(29,1,1) = {"
je
je
je
je
bM
hW
QX
hW
hW
hW
hW
hW
hW
hW
hW
hW
vd
An
bM
je
je
je
je
je
je
"}
(30,1,1) = {"
je
je
je
je
bM
An
bM
An
Bc
Bc
Bc
Bc
Bc
Bc
Bc
An
bM
KS
bM
je
je
je
je
je
je
"}
(31,1,1) = {"
je
je
je
je
je
je
je
je
je
je
je
je
je
je
je
je
je
je
je
je
je
je
je
je
je
"}
(32,1,1) = {"
je
je
je
je
je
je
je
je
je
je
je
je
je
je
je
je
je
je
je
je
je
je
je
je
je
"}
(33,1,1) = {"
je
je
je
je
je
je
je
je
je
je
je
je
je
je
je
je
je
je
je
je
je
je
je
je
je
"}
