//MAP CONVERTED BY dmm2tgm.py THIS HEADER COMMENT PREVENTS RECONVERSION, DO NOT REMOVE
"a" = (
/obj/effect/spawner/deleter,
/turf/open/space/basic,
/area/space)
"g" = (
/turf/template_noop,
/area/template_noop)
"j" = (
/obj/effect/spawner/deleter/apc,
/turf/open/space/basic,
/area/space)

(1,1,1) = {"
g
g
g
g
a
a
a
a
a
a
a
a
a
a
a
a
a
a
a
a
a
g
g
"}
(2,1,1) = {"
g
g
g
g
a
a
a
a
a
a
a
a
a
a
a
a
a
a
a
a
a
g
g
"}
(3,1,1) = {"
g
g
g
g
a
a
a
a
a
a
a
a
a
a
a
a
a
a
a
a
a
g
g
"}
(4,1,1) = {"
g
g
g
g
a
a
a
a
a
a
a
a
a
a
a
a
a
a
a
a
a
g
g
"}
(5,1,1) = {"
g
g
g
g
a
a
a
a
a
a
a
a
a
a
a
a
a
a
a
a
a
g
g
"}
(6,1,1) = {"
g
g
g
g
a
a
a
a
a
a
a
a
a
a
a
a
a
a
a
a
a
g
g
"}
(7,1,1) = {"
g
g
g
g
a
a
a
a
a
a
a
a
a
a
a
a
a
a
a
a
a
g
g
"}
(8,1,1) = {"
g
g
g
g
a
a
a
a
a
a
a
a
a
a
a
a
a
a
a
a
a
g
g
"}
(9,1,1) = {"
g
g
g
g
a
a
a
a
a
a
a
a
a
a
a
a
a
a
a
a
a
g
g
"}
(10,1,1) = {"
g
g
g
g
a
a
a
a
a
a
a
a
a
a
a
a
a
a
a
a
a
g
g
"}
(11,1,1) = {"
g
g
g
g
a
a
a
a
a
a
a
a
a
a
a
a
a
a
a
a
a
g
g
"}
(12,1,1) = {"
g
g
g
g
a
a
a
a
a
a
a
a
a
a
a
a
a
a
a
a
a
g
g
"}
(13,1,1) = {"
g
g
g
g
a
a
a
a
a
a
a
a
a
a
a
a
a
a
a
a
a
g
g
"}
(14,1,1) = {"
g
a
a
a
a
a
a
a
a
a
a
a
a
a
a
a
a
a
a
a
a
g
g
"}
(15,1,1) = {"
g
a
a
a
a
a
a
a
a
a
a
a
a
a
a
a
a
a
a
a
a
g
g
"}
(16,1,1) = {"
g
a
a
a
a
a
a
a
a
a
a
a
a
a
a
a
a
a
a
a
a
g
g
"}
(17,1,1) = {"
a
a
a
a
a
a
a
a
a
a
a
a
a
a
a
a
a
a
a
a
a
g
g
"}
(18,1,1) = {"
a
a
a
a
a
a
a
a
a
a
a
a
a
a
a
a
a
a
a
a
a
g
g
"}
(19,1,1) = {"
a
a
a
a
a
a
a
a
a
a
a
a
a
a
a
a
a
a
a
a
a
g
g
"}
(20,1,1) = {"
a
a
a
a
a
a
a
a
a
a
a
a
a
a
a
a
a
a
a
a
a
g
g
"}
(21,1,1) = {"
a
a
a
a
a
a
a
a
a
a
a
a
a
a
a
a
a
a
a
a
a
g
g
"}
(22,1,1) = {"
a
a
a
a
a
a
a
a
a
a
a
a
a
a
a
a
a
a
a
a
a
g
g
"}
(23,1,1) = {"
a
j
a
a
a
a
a
a
a
a
a
a
a
a
a
a
a
a
a
a
a
g
g
"}
(24,1,1) = {"
a
a
a
a
a
a
a
a
a
a
a
a
a
a
a
a
a
a
a
a
a
g
g
"}
(25,1,1) = {"
a
a
a
a
a
a
a
a
a
a
a
a
a
a
a
a
a
a
a
a
a
g
g
"}
(26,1,1) = {"
a
a
a
a
a
a
a
a
a
a
a
a
a
a
a
a
a
a
a
a
a
a
a
"}
(27,1,1) = {"
a
a
a
a
a
a
a
a
a
a
a
a
a
a
a
a
a
a
a
a
a
a
a
"}
(28,1,1) = {"
a
a
a
a
a
a
a
a
a
a
a
a
a
a
a
a
a
a
a
a
a
a
a
"}
(29,1,1) = {"
a
a
a
a
a
a
a
a
a
a
a
a
a
a
a
a
a
a
a
a
a
a
a
"}
(30,1,1) = {"
a
a
a
a
a
a
a
a
a
a
a
a
a
a
a
a
a
a
a
a
a
a
a
"}
(31,1,1) = {"
a
a
a
a
a
a
a
a
a
a
a
a
a
a
a
a
a
a
a
a
a
a
a
"}
