//MAP CONVERTED BY dmm2tgm.py THIS HEADER COMMENT PREVENTS RECONVERSION, DO NOT REMOVE
"a" = (
/obj/effect/landmark/deleter,
/turf/open/space/basic,
/area/space)
"o" = (
/turf/template_noop,
/area/template_noop)
"y" = (
/obj/effect/landmark/deleter/apc,
/turf/open/space/basic,
/area/space)

(1,1,1) = {"
o
o
o
o
a
a
a
a
a
a
a
a
a
a
a
a
a
a
a
a
a
o
o
"}
(2,1,1) = {"
o
o
o
o
a
a
a
a
a
a
a
a
a
a
a
a
a
a
a
a
a
o
o
"}
(3,1,1) = {"
o
o
o
o
a
a
a
a
a
a
a
a
a
a
a
a
a
a
a
a
a
o
o
"}
(4,1,1) = {"
o
o
o
o
a
a
a
a
a
a
a
a
a
a
a
a
a
a
a
a
a
o
o
"}
(5,1,1) = {"
o
o
o
o
a
a
a
a
a
a
a
a
a
a
a
a
a
a
a
a
a
o
o
"}
(6,1,1) = {"
o
o
o
o
a
a
a
a
a
a
a
a
a
a
a
a
a
a
a
a
a
o
o
"}
(7,1,1) = {"
o
o
o
o
a
a
a
a
a
a
a
a
a
a
a
a
a
a
a
a
a
o
o
"}
(8,1,1) = {"
o
o
o
o
a
a
a
a
a
a
a
a
a
a
a
a
a
a
a
a
a
o
o
"}
(9,1,1) = {"
o
o
o
o
a
a
a
a
a
a
a
a
a
a
a
a
a
a
a
a
a
o
o
"}
(10,1,1) = {"
o
o
o
o
a
a
a
a
a
a
a
a
a
a
a
a
a
a
a
a
a
o
o
"}
(11,1,1) = {"
o
o
o
o
a
a
a
a
a
a
a
a
a
a
a
a
a
a
a
a
a
o
o
"}
(12,1,1) = {"
o
o
o
o
a
a
a
a
a
a
a
a
a
a
a
a
a
a
a
a
a
o
o
"}
(13,1,1) = {"
o
o
o
o
a
a
a
a
a
a
a
a
a
a
a
a
a
a
a
a
a
o
o
"}
(14,1,1) = {"
o
o
o
o
a
a
a
a
a
a
a
a
a
a
a
a
a
a
a
a
a
o
o
"}
(15,1,1) = {"
o
o
o
o
a
a
a
a
a
a
a
a
a
a
a
a
a
a
a
a
a
o
o
"}
(16,1,1) = {"
o
a
a
a
a
a
a
a
a
a
a
a
a
a
a
a
a
a
a
a
a
o
o
"}
(17,1,1) = {"
o
a
a
a
a
a
a
a
a
a
a
a
a
a
a
a
a
a
a
a
a
o
o
"}
(18,1,1) = {"
o
a
a
a
a
a
a
a
a
a
a
a
a
a
a
a
a
a
a
a
a
o
o
"}
(19,1,1) = {"
a
a
a
a
a
a
a
a
a
a
a
a
a
a
a
a
a
a
a
a
a
o
o
"}
(20,1,1) = {"
a
a
a
a
a
a
a
a
a
a
a
a
a
a
a
a
a
a
a
a
a
o
o
"}
(21,1,1) = {"
a
a
a
a
a
a
a
a
a
a
a
a
a
a
a
a
a
a
a
a
a
o
o
"}
(22,1,1) = {"
a
a
a
a
a
a
a
a
a
a
a
a
a
a
a
a
a
a
a
a
a
o
o
"}
(23,1,1) = {"
a
a
a
a
a
a
a
a
a
a
a
a
a
a
a
a
a
a
a
a
a
o
o
"}
(24,1,1) = {"
a
a
a
a
a
a
a
a
a
a
a
a
a
a
a
a
a
a
a
a
a
o
o
"}
(25,1,1) = {"
a
y
a
a
a
a
a
a
a
a
a
a
a
a
a
a
a
a
a
a
a
o
o
"}
(26,1,1) = {"
a
a
a
a
a
a
a
a
a
a
a
a
a
a
a
a
a
a
a
a
a
o
o
"}
(27,1,1) = {"
a
a
a
a
a
a
a
a
a
a
a
a
a
a
a
a
a
a
a
a
a
o
o
"}
(28,1,1) = {"
a
a
a
a
a
a
a
a
a
a
a
a
a
a
a
a
a
a
a
a
a
a
a
"}
(29,1,1) = {"
a
a
a
a
a
a
a
a
a
a
a
a
a
a
a
a
a
a
a
a
a
a
a
"}
(30,1,1) = {"
a
a
a
a
a
a
a
a
a
a
a
a
a
a
a
a
a
a
a
a
a
a
a
"}
(31,1,1) = {"
a
a
a
a
a
a
a
a
a
a
a
a
a
a
a
a
a
a
a
a
a
a
a
"}
(32,1,1) = {"
a
a
a
a
a
a
a
a
a
a
a
a
a
a
a
a
a
a
a
a
a
a
a
"}
(33,1,1) = {"
a
a
a
a
a
a
a
a
a
a
a
a
a
a
a
a
a
a
a
a
a
a
a
"}
