//MAP CONVERTED BY dmm2tgm.py THIS HEADER COMMENT PREVENTS RECONVERSION, DO NOT REMOVE
"aq" = (
/obj/structure/chair/office{
	dir = 4
	},
/obj/item/radio/intercom/directional/north,
/obj/machinery/light/directional/north,
/turf/open/floor/carpet/black,
/area/station/engineering/supermatter/room)
"aA" = (
/obj/item/kirbyplants/random,
/obj/machinery/firealarm/directional/east,
/turf/open/floor/iron,
/area/station/engineering/supermatter/room)
"aJ" = (
/obj/machinery/light/directional/south,
/turf/open/floor/iron/dark,
/area/station/engineering/supermatter/room)
"aR" = (
/obj/machinery/power/smes/engineering,
/obj/structure/cable,
/turf/open/floor/iron,
/area/station/engineering/supermatter/room)
"be" = (
/obj/machinery/door/airlock/highsecurity{
	name = "Emergency Access"
	},
/obj/effect/mapping_helpers/airlock/cyclelink_helper,
/obj/effect/turf_decal/stripes/line,
/obj/effect/turf_decal/stripes/line{
	dir = 1
	},
/obj/machinery/door/firedoor/heavy,
/obj/effect/mapping_helpers/airlock/access/all/engineering/general,
/turf/open/floor/iron,
/area/station/engineering/supermatter/room)
"bl" = (
/obj/machinery/power/energy_accumulator/tesla_coil,
/turf/open/floor/iron/dark,
/area/station/engineering/supermatter/room)
"bv" = (
/obj/machinery/atmospherics/components/unary/vent_scrubber/on/layer2{
	dir = 1
	},
/turf/open/floor/iron,
/area/station/engineering/supermatter/room)
"bJ" = (
/obj/effect/decal/cleanable/dirt,
/obj/machinery/firealarm/directional/east,
/turf/open/floor/iron/dark,
/area/station/engineering/supermatter/room)
"cb" = (
/obj/machinery/power/emitter,
/obj/structure/cable,
/turf/open/floor/plating/airless,
/area/space/nearstation)
"cd" = (
/obj/machinery/atmospherics/pipe/smart/manifold4w/supply/hidden/layer4,
/obj/machinery/atmospherics/pipe/smart/manifold4w/scrubbers/hidden/layer2,
/obj/machinery/power/energy_accumulator/rad_collector,
/turf/open/floor/iron,
/area/station/engineering/supermatter/room)
"cw" = (
/obj/structure/lattice/catwalk,
/obj/structure/grille,
/obj/structure/grille,
/turf/open/space/basic,
/area/space/nearstation)
"cE" = (
/obj/structure/lattice,
/turf/open/space/basic,
/area/space/nearstation)
"cT" = (
/obj/machinery/atmospherics/components/unary/vent_pump/on/layer4{
	dir = 1
	},
/obj/structure/extinguisher_cabinet/directional/south,
/obj/effect/decal/cleanable/dirt,
/obj/machinery/light/directional/south,
/turf/open/floor/iron,
/area/station/engineering/supermatter/room)
"dy" = (
/obj/machinery/atmospherics/pipe/smart/manifold4w/scrubbers/hidden/layer2,
/obj/machinery/atmospherics/pipe/smart/manifold4w/supply/hidden/layer4,
/turf/open/floor/iron/checker,
/area/station/engineering/supermatter/room)
"eg" = (
/obj/structure/table/reinforced,
/obj/item/wrench,
/turf/open/floor/iron/dark,
/area/station/engineering/supermatter/room)
"eC" = (
/obj/structure/cable,
/turf/open/floor/carpet/black,
/area/station/engineering/supermatter/room)
"eD" = (
/turf/open/floor/iron/dark,
/area/station/engineering/supermatter/room)
"eJ" = (
/obj/structure/cable,
/obj/machinery/door/firedoor,
/obj/machinery/door/airlock/engineering/glass{
	name = "Supermatter Engine Room"
	},
/obj/effect/mapping_helpers/airlock/access/all/engineering/general,
/turf/open/floor/iron,
/area/station/engineering/supermatter/room)
"fa" = (
/obj/structure/cable,
/obj/machinery/atmospherics/components/unary/vent_pump/on/layer4{
	dir = 8
	},
/turf/open/floor/carpet/black,
/area/station/engineering/supermatter/room)
"fi" = (
/obj/machinery/atmospherics/pipe/smart/manifold4w/scrubbers/hidden/layer2,
/obj/machinery/atmospherics/pipe/smart/manifold4w/supply/hidden/layer4,
/turf/open/floor/iron,
/area/station/engineering/supermatter/room)
"fG" = (
/turf/template_noop,
/area/template_noop)
"fL" = (
/obj/structure/closet/firecloset,
/turf/open/floor/iron,
/area/station/engineering/supermatter/room)
"fW" = (
/obj/effect/turf_decal/stripes/line{
	dir = 10
	},
/obj/machinery/particle_accelerator/particle_emitter/right{
	anchored = 1;
	construction_state = 3;
	dir = 8
	},
/turf/open/floor/plating,
/area/station/engineering/supermatter/room)
"gv" = (
/obj/structure/cable/layer1,
/obj/machinery/incident_display/delam/directional/south,
/turf/open/floor/iron,
/area/station/engineering/supermatter/room)
"gC" = (
/obj/structure/table/reinforced,
/obj/item/crowbar,
/turf/open/floor/iron,
/area/station/engineering/supermatter/room)
"gH" = (
/obj/structure/cable/multilayer/connected,
/turf/open/floor/plating/airless,
/area/space/nearstation)
"gN" = (
/obj/effect/turf_decal/stripes/line{
	dir = 8
	},
/obj/machinery/particle_accelerator/particle_emitter/center{
	anchored = 1;
	construction_state = 3;
	dir = 8
	},
/turf/open/floor/plating,
/area/station/engineering/supermatter/room)
"gR" = (
/obj/effect/decal/cleanable/dirt,
/obj/machinery/light/directional/north,
/turf/open/floor/iron/dark,
/area/station/engineering/supermatter/room)
"hg" = (
/obj/machinery/atmospherics/components/unary/vent_pump/on/layer4{
	dir = 8
	},
/turf/open/floor/iron,
/area/station/engineering/supermatter/room)
"hk" = (
/obj/machinery/atmospherics/pipe/smart/manifold4w/supply/hidden/layer4,
/obj/machinery/atmospherics/pipe/smart/manifold4w/scrubbers/hidden/layer2,
/turf/open/floor/iron/dark,
/area/station/engineering/supermatter/room)
"hn" = (
/obj/machinery/light/directional/east,
/turf/open/floor/iron/dark,
/area/station/engineering/supermatter/room)
"hD" = (
/obj/machinery/door/airlock/external,
/obj/effect/mapping_helpers/airlock/access/all/engineering/general,
/obj/effect/mapping_helpers/airlock/cyclelink_helper{
	dir = 4
	},
/turf/open/floor/plating,
/area/station/engineering/supermatter/room)
"im" = (
/obj/effect/turf_decal/stripes/line{
	dir = 5
	},
/turf/open/floor/plating,
/area/station/engineering/supermatter/room)
"iV" = (
/obj/effect/decal/cleanable/dirt,
/obj/machinery/atmospherics/pipe/smart/manifold4w/supply/hidden/layer4,
/obj/machinery/atmospherics/pipe/smart/manifold4w/scrubbers/hidden/layer2,
/obj/machinery/power/energy_accumulator/grounding_rod,
/turf/open/floor/iron,
/area/station/engineering/supermatter/room)
"jk" = (
/obj/structure/chair/sofa/corp/left{
	dir = 8
	},
/turf/open/floor/carpet/black,
/area/station/engineering/supermatter/room)
"jK" = (
/obj/effect/decal/cleanable/dirt,
/obj/machinery/light/directional/south,
/turf/open/floor/iron/dark,
/area/station/engineering/supermatter/room)
"ku" = (
/obj/machinery/atmospherics/pipe/smart/manifold4w/scrubbers/hidden/layer2,
/obj/machinery/atmospherics/pipe/smart/manifold4w/supply/hidden/layer4,
/obj/machinery/door/firedoor,
/obj/machinery/door/airlock/engineering/glass{
	name = "Supermatter Engine Room"
	},
/obj/effect/mapping_helpers/airlock/access/all/engineering/general,
/turf/open/floor/iron,
/area/station/engineering/supermatter/room)
"lq" = (
/obj/structure/cable/layer1,
/obj/structure/cable,
/obj/effect/turf_decal/tile/yellow/opposingcorners,
/turf/open/floor/iron,
/area/station/engineering/supermatter/room)
"lO" = (
/turf/closed/wall/r_wall,
/area/station/engineering/supermatter/room)
"mv" = (
/obj/item/toy/spinningtoy/dark_matter,
/turf/template_noop,
/area/template_noop)
"mx" = (
/obj/machinery/atmospherics/components/unary/vent_scrubber/on/layer2{
	dir = 8
	},
/turf/open/floor/iron,
/area/station/engineering/supermatter/room)
"nr" = (
/obj/structure/cable,
/turf/open/floor/iron,
/area/station/engineering/supermatter/room)
"nO" = (
/obj/machinery/atmospherics/components/unary/vent_pump/on/layer4{
	dir = 1
	},
/turf/open/floor/iron/dark,
/area/station/engineering/supermatter/room)
"oD" = (
/obj/structure/lattice/catwalk,
/obj/structure/cable,
/turf/open/space/basic,
/area/space/nearstation)
"pv" = (
/obj/effect/turf_decal/tile/yellow/opposingcorners,
/obj/machinery/atmospherics/pipe/smart/manifold4w/scrubbers/hidden/layer2,
/obj/machinery/atmospherics/pipe/smart/manifold4w/supply/hidden/layer4,
/turf/open/floor/iron,
/area/station/engineering/supermatter/room)
"pG" = (
/obj/item/radio/intercom/directional/south,
/turf/open/floor/iron,
/area/station/engineering/supermatter/room)
"pT" = (
/obj/effect/decal/cleanable/dirt,
/obj/machinery/atmospherics/components/unary/vent_pump/on/layer4{
	dir = 4
	},
/obj/machinery/power/energy_accumulator/tesla_coil,
/turf/open/floor/iron/dark,
/area/station/engineering/supermatter/room)
"pV" = (
/obj/structure/sign/warning/radiation,
/turf/closed/wall/r_wall,
/area/station/maintenance/port)
"qo" = (
/obj/item/kirbyplants/random,
/turf/open/floor/carpet/black,
/area/station/engineering/supermatter/room)
"qV" = (
/obj/effect/turf_decal/tile/yellow/opposingcorners,
/obj/structure/cable,
/obj/machinery/atmospherics/pipe/smart/manifold4w/scrubbers/hidden/layer2,
/obj/machinery/atmospherics/pipe/smart/manifold4w/supply/hidden/layer4,
/obj/effect/decal/cleanable/dirt,
/turf/open/floor/iron,
/area/station/engineering/supermatter/room)
"re" = (
/obj/structure/cable,
/obj/effect/decal/cleanable/dirt,
/turf/open/floor/iron,
/area/station/engineering/supermatter/room)
"rp" = (
/turf/closed/wall/r_wall,
/area/space/nearstation)
"rF" = (
/obj/machinery/atmospherics/pipe/smart/manifold4w/supply/hidden/layer4,
/obj/machinery/atmospherics/pipe/smart/manifold4w/scrubbers/hidden/layer2,
/obj/machinery/power/energy_accumulator/grounding_rod,
/turf/open/floor/iron,
/area/station/engineering/supermatter/room)
"sm" = (
/obj/structure/cable,
/obj/machinery/atmospherics/pipe/smart/manifold4w/scrubbers/hidden/layer2,
/obj/machinery/atmospherics/pipe/smart/manifold4w/supply/hidden/layer4,
/obj/machinery/door/airlock/engineering/glass{
	name = "Supermatter Engine Room"
	},
/obj/effect/mapping_helpers/airlock/access/all/engineering/general,
/obj/machinery/door/firedoor,
/turf/open/floor/iron,
/area/station/engineering/supermatter/room)
"sA" = (
/obj/machinery/atmospherics/pipe/smart/manifold4w/supply/hidden/layer4,
/obj/machinery/atmospherics/pipe/smart/manifold4w/scrubbers/hidden/layer2,
/obj/machinery/power/energy_accumulator/tesla_coil,
/turf/open/floor/iron,
/area/station/engineering/supermatter/room)
"tt" = (
/obj/structure/grille,
/turf/open/space/basic,
/area/space/nearstation)
"up" = (
/obj/structure/cable,
/obj/effect/turf_decal/bot_white/right,
/turf/open/floor/plating/airless,
/area/space/nearstation)
"uq" = (
/turf/open/floor/carpet/black,
/area/station/engineering/supermatter/room)
"ur" = (
/obj/item/multitool,
/obj/item/clothing/gloves/color/yellow,
/obj/structure/table/reinforced,
/turf/open/floor/iron,
/area/station/engineering/supermatter/room)
"uA" = (
/obj/machinery/camera/emp_proof/directional/west{
	dir = 4;
	c_tag = "Singularity Engine #2"
	},
/turf/open/space/basic,
/area/space/nearstation)
"uI" = (
/obj/machinery/door/airlock/external,
/obj/effect/mapping_helpers/airlock/access/all/engineering/general,
/obj/effect/mapping_helpers/airlock/cyclelink_helper{
	dir = 4
	},
/obj/structure/cable/layer1,
/obj/structure/cable,
/turf/open/floor/plating,
/area/station/engineering/supermatter/room)
"uV" = (
/obj/structure/lattice/catwalk,
/obj/machinery/camera/emp_proof/directional/west{
	c_tag = "Singularity Engine #4"
	},
/turf/open/space/basic,
/area/space/nearstation)
"va" = (
/obj/structure/lattice/catwalk,
/turf/open/space/basic,
/area/space/nearstation)
"vg" = (
/obj/effect/turf_decal/stripes/line,
/turf/open/floor/plating,
/area/station/engineering/supermatter/room)
"vG" = (
/obj/effect/decal/cleanable/dirt,
/turf/open/floor/iron/dark,
/area/station/engineering/supermatter/room)
"wo" = (
/obj/machinery/power/terminal{
	dir = 8
	},
/obj/structure/cable,
/obj/effect/decal/cleanable/dirt,
/turf/open/floor/iron,
/area/station/engineering/supermatter/room)
"xf" = (
/obj/machinery/firealarm/directional/east,
/turf/open/floor/iron,
/area/station/engineering/supermatter/room)
"xj" = (
/obj/structure/cable,
/obj/effect/turf_decal/tile/yellow/opposingcorners,
/obj/machinery/atmospherics/pipe/smart/manifold4w/scrubbers/hidden/layer2,
/obj/machinery/atmospherics/pipe/smart/manifold4w/supply/hidden/layer4,
/turf/open/floor/iron,
/area/station/engineering/supermatter/room)
"xw" = (
/obj/machinery/newscaster/directional/east,
/obj/effect/spawner/structure/window/reinforced/plasma,
/turf/open/floor/plating,
/area/station/engineering/supermatter/room)
"xG" = (
/obj/structure/cable,
/obj/effect/turf_decal/bot_white/left,
/turf/open/floor/plating/airless,
/area/space/nearstation)
"xM" = (
/obj/machinery/door/airlock/external,
/obj/effect/mapping_helpers/airlock/access/all/engineering/general,
/obj/effect/mapping_helpers/airlock/cyclelink_helper{
	dir = 8
	},
/obj/structure/fans/tiny,
/obj/structure/cable/layer1,
/obj/structure/cable,
/turf/open/floor/plating,
/area/station/engineering/supermatter/room)
"xN" = (
/obj/structure/closet/radiation,
/obj/machinery/light/directional/east,
/turf/open/floor/iron,
/area/station/engineering/supermatter/room)
"xR" = (
/obj/structure/chair/sofa/corp/corner,
/turf/open/floor/carpet/black,
/area/station/engineering/supermatter/room)
"yb" = (
/obj/item/kirbyplants/random,
/turf/open/floor/iron,
/area/station/engineering/supermatter/room)
"yt" = (
/turf/open/floor/iron,
/area/station/engineering/supermatter/room)
"ze" = (
/obj/effect/decal/cleanable/dirt,
/turf/open/floor/iron,
/area/station/engineering/supermatter/room)
"zl" = (
/obj/effect/turf_decal/bot{
	dir = 1
	},
/obj/machinery/field/generator,
/turf/open/floor/plating/airless,
/area/space/nearstation)
"zn" = (
/obj/structure/lattice/catwalk,
/obj/structure/cable/layer1,
/turf/open/space/basic,
/area/space/nearstation)
"zs" = (
/obj/structure/table/reinforced,
/turf/open/floor/iron,
/area/station/engineering/supermatter/room)
"Ae" = (
/obj/item/radio/intercom/directional/north,
/obj/machinery/atmospherics/pipe/smart/manifold4w/supply/hidden/layer4,
/obj/machinery/atmospherics/pipe/smart/manifold4w/scrubbers/hidden/layer2,
/turf/open/floor/iron,
/area/station/engineering/supermatter/room)
"Aw" = (
/obj/structure/cable,
/obj/machinery/atmospherics/pipe/smart/manifold4w/scrubbers/hidden/layer2,
/obj/machinery/atmospherics/pipe/smart/manifold4w/supply/hidden/layer4,
/turf/open/floor/carpet/black,
/area/station/engineering/supermatter/room)
"AD" = (
/obj/machinery/particle_accelerator/fuel_chamber{
	dir = 8;
	anchored = 1;
	construction_state = 3
	},
/turf/open/floor/plating,
/area/station/engineering/supermatter/room)
"AH" = (
/obj/machinery/atmospherics/pipe/smart/manifold4w/scrubbers/hidden/layer2,
/obj/machinery/atmospherics/pipe/smart/manifold4w/supply/hidden/layer4,
/obj/effect/decal/cleanable/dirt,
/turf/open/floor/iron/checker,
/area/station/engineering/supermatter/room)
"Bf" = (
/obj/structure/lattice/catwalk,
/obj/structure/cable/layer1,
/obj/structure/cable,
/turf/open/space/basic,
/area/space/nearstation)
"Bl" = (
/obj/effect/turf_decal/stripes/line{
	dir = 6
	},
/turf/open/floor/plating,
/area/station/engineering/supermatter/room)
"BW" = (
/obj/machinery/particle_accelerator/power_box{
	anchored = 1;
	construction_state = 3;
	dir = 8
	},
/turf/open/floor/plating,
/area/station/engineering/supermatter/room)
"DA" = (
/obj/effect/turf_decal/stripes/line{
	dir = 1
	},
/obj/machinery/particle_accelerator/control_box{
	anchored = 1;
	construction_state = 3
	},
/turf/open/floor/plating,
/area/station/engineering/supermatter/room)
"DJ" = (
/obj/structure/cable,
/obj/effect/turf_decal/tile/yellow/opposingcorners,
/obj/machinery/atmospherics/pipe/smart/manifold4w/scrubbers/hidden/layer2,
/obj/machinery/atmospherics/pipe/smart/manifold4w/supply/hidden/layer4,
/obj/effect/decal/cleanable/dirt,
/turf/open/floor/iron,
/area/station/engineering/supermatter/room)
"Es" = (
/obj/effect/turf_decal/stripes/line{
	dir = 9
	},
/obj/machinery/particle_accelerator/particle_emitter/left{
	anchored = 1;
	construction_state = 3;
	dir = 8
	},
/turf/open/floor/plating,
/area/station/engineering/supermatter/room)
"Ez" = (
/obj/machinery/firealarm/directional/south,
/turf/open/floor/carpet/black,
/area/station/engineering/supermatter/room)
"EH" = (
/obj/effect/turf_decal/bot_red,
/turf/open/floor/plating/airless,
/area/space/nearstation)
"EJ" = (
/obj/effect/turf_decal/bot{
	dir = 1
	},
/turf/open/floor/plating/airless,
/area/space/nearstation)
"EZ" = (
/obj/structure/lattice/catwalk,
/obj/machinery/camera/emp_proof/directional/west{
	c_tag = "Singularity Engine #3"
	},
/turf/open/space/basic,
/area/space/nearstation)
"Fj" = (
/obj/structure/cable,
/obj/machinery/atmospherics/pipe/smart/manifold4w/scrubbers/hidden/layer2,
/obj/machinery/atmospherics/pipe/smart/manifold4w/supply/hidden/layer4,
/turf/open/floor/iron,
/area/station/engineering/supermatter/room)
"FS" = (
/obj/structure/table/reinforced,
/obj/item/screwdriver,
/obj/item/crowbar,
/turf/open/floor/iron/dark,
/area/station/engineering/supermatter/room)
"Gj" = (
/obj/structure/cable,
/obj/machinery/atmospherics/components/unary/vent_pump/on/layer4,
/turf/open/floor/iron,
/area/station/engineering/supermatter/room)
"Gq" = (
/obj/machinery/door/airlock/external,
/obj/effect/mapping_helpers/airlock/access/all/engineering/general,
/obj/effect/mapping_helpers/airlock/cyclelink_helper{
	dir = 8
	},
/obj/structure/fans/tiny,
/turf/open/floor/plating,
/area/station/engineering/supermatter/room)
"Hm" = (
/obj/structure/chair/sofa/corp/right,
/obj/machinery/light/directional/north,
/turf/open/floor/carpet/black,
/area/station/engineering/supermatter/room)
"HJ" = (
/obj/structure/chair/sofa/corp{
	dir = 8
	},
/turf/open/floor/carpet/black,
/area/station/engineering/supermatter/room)
"Ip" = (
/obj/machinery/atmospherics/pipe/smart/manifold4w/scrubbers/hidden/layer2,
/obj/machinery/atmospherics/pipe/smart/manifold4w/supply/hidden/layer4,
/obj/effect/mapping_helpers/airlock/access/all/engineering/general,
/obj/machinery/door/airlock/engineering/glass{
	name = "Supermatter Engine Room"
	},
/obj/machinery/door/firedoor,
/turf/open/floor/iron,
/area/station/engineering/supermatter/room)
"IQ" = (
/turf/closed/wall/r_wall,
/area/station/maintenance/department/science/xenobiology)
"IY" = (
/obj/structure/closet/secure_closet/engineering_electrical,
/turf/open/floor/iron,
/area/station/engineering/supermatter/room)
"Ke" = (
/obj/machinery/light/directional/west,
/turf/open/floor/iron,
/area/station/engineering/supermatter/room)
"Kf" = (
/obj/structure/table,
/turf/open/floor/carpet/black,
/area/station/engineering/supermatter/room)
"Ki" = (
/obj/effect/spawner/structure/window/reinforced/plasma,
/turf/open/floor/plating,
/area/station/engineering/supermatter/room)
"KB" = (
/obj/effect/turf_decal/stripes/line{
	dir = 4
	},
/obj/machinery/particle_accelerator/end_cap{
	anchored = 1;
	construction_state = 3;
	dir = 8
	},
/turf/open/floor/plating,
/area/station/engineering/supermatter/room)
"KI" = (
/obj/machinery/atmospherics/pipe/smart/manifold4w/scrubbers/hidden/layer2,
/turf/open/floor/carpet/black,
/area/station/engineering/supermatter/room)
"KK" = (
/obj/machinery/atmospherics/pipe/smart/manifold4w/scrubbers/hidden/layer2,
/obj/machinery/atmospherics/pipe/smart/manifold4w/supply/hidden/layer4,
/turf/open/floor/iron/dark,
/area/station/engineering/supermatter/room)
"Lc" = (
/obj/machinery/firealarm/directional/west,
/obj/machinery/light/directional/west,
/turf/open/floor/iron,
/area/station/engineering/supermatter/room)
"LQ" = (
/obj/effect/turf_decal/tile/yellow/opposingcorners,
/obj/structure/cable,
/obj/machinery/atmospherics/pipe/smart/manifold4w/scrubbers/hidden/layer2,
/obj/machinery/atmospherics/pipe/smart/manifold4w/supply/hidden/layer4,
/turf/open/floor/iron,
/area/station/engineering/supermatter/room)
"Mm" = (
/obj/item/radio/intercom/directional/north,
/obj/effect/decal/cleanable/dirt,
/obj/machinery/light/directional/north,
/turf/open/floor/iron/dark,
/area/station/engineering/supermatter/room)
"MA" = (
/obj/structure/chair,
/turf/open/floor/iron,
/area/station/engineering/supermatter/room)
"MF" = (
/obj/structure/cable,
/obj/machinery/atmospherics/pipe/smart/manifold4w/scrubbers/hidden/layer2,
/obj/machinery/atmospherics/pipe/smart/manifold4w/supply/hidden/layer4,
/obj/machinery/door/firedoor,
/obj/machinery/door/airlock/engineering/glass{
	name = "Supermatter Engine Room"
	},
/obj/effect/mapping_helpers/airlock/access/all/engineering/general,
/turf/open/floor/iron,
/area/station/engineering/supermatter/room)
"MU" = (
/obj/machinery/power/emitter{
	dir = 8
	},
/obj/structure/cable,
/turf/open/floor/plating/airless,
/area/space/nearstation)
"No" = (
/obj/machinery/door/firedoor,
/obj/machinery/door/airlock/engineering/glass{
	name = "Supermatter Engine Room"
	},
/obj/effect/mapping_helpers/airlock/access/all/engineering/general,
/obj/effect/turf_decal/stripes/line,
/obj/effect/turf_decal/stripes/line{
	dir = 1
	},
/turf/open/floor/iron,
/area/station/engineering/supermatter/room)
"NF" = (
/obj/structure/chair/office{
	dir = 8
	},
/turf/open/floor/carpet/black,
/area/station/engineering/supermatter/room)
"Pv" = (
/obj/structure/cable,
/obj/structure/extinguisher_cabinet/directional/south,
/turf/open/floor/iron,
/area/station/engineering/supermatter/room)
"PP" = (
/turf/open/floor/plating,
/area/station/engineering/supermatter/room)
"PQ" = (
/obj/machinery/atmospherics/components/unary/vent_scrubber/on/layer2{
	dir = 4
	},
/turf/open/floor/carpet/black,
/area/station/engineering/supermatter/room)
"QK" = (
/obj/structure/cable,
/obj/effect/turf_decal/tile/yellow/opposingcorners,
/turf/open/floor/iron,
/area/station/engineering/supermatter/room)
"QP" = (
/obj/machinery/airalarm/directional/west,
/turf/open/floor/iron,
/area/station/engineering/supermatter/room)
"Ri" = (
/obj/machinery/light/directional/south,
/obj/structure/sign/warning/vacuum/external/directional/south,
/turf/open/floor/plating,
/area/station/engineering/supermatter/room)
"Rx" = (
/turf/open/space/basic,
/area/space/nearstation)
"Rz" = (
/obj/structure/cable/layer1,
/obj/structure/cable,
/turf/open/floor/plating,
/area/station/engineering/supermatter/room)
"RG" = (
/obj/structure/tank_dispenser,
/turf/open/floor/iron,
/area/station/engineering/supermatter/room)
"Sg" = (
/obj/structure/table,
/obj/effect/spawner/random/entertainment/deck,
/turf/open/floor/carpet/black,
/area/station/engineering/supermatter/room)
"SV" = (
/turf/closed/wall/r_wall,
/area/station/maintenance/port)
"TW" = (
/obj/structure/cable,
/obj/structure/cable/layer1,
/turf/open/floor/plating/airless,
/area/space/nearstation)
"UC" = (
/obj/effect/turf_decal/tile/yellow/opposingcorners,
/obj/structure/cable,
/obj/machinery/atmospherics/pipe/smart/manifold4w/scrubbers/hidden/layer2,
/obj/machinery/atmospherics/pipe/smart/manifold4w/supply/hidden/layer4,
/obj/machinery/newscaster/directional/south,
/turf/open/floor/iron,
/area/station/engineering/supermatter/room)
"UX" = (
/obj/structure/sign/warning/radiation,
/turf/closed/wall/r_wall,
/area/station/engineering/supermatter/room)
"Ve" = (
/obj/structure/lattice/catwalk,
/obj/structure/grille,
/turf/open/space/basic,
/area/space/nearstation)
"Vi" = (
/obj/machinery/camera/emp_proof/directional/west{
	dir = 4;
	c_tag = "Singularity Engine #1"
	},
/turf/open/space/basic,
/area/space/nearstation)
"Vl" = (
/turf/open/floor/plating/airless,
/area/space/nearstation)
"Vz" = (
/obj/structure/chair/office{
	dir = 4
	},
/turf/open/floor/carpet/black,
/area/station/engineering/supermatter/room)
"VR" = (
/obj/machinery/power/energy_accumulator/rad_collector,
/turf/open/floor/iron/dark,
/area/station/engineering/supermatter/room)
"Wr" = (
/obj/structure/extinguisher_cabinet/directional/south,
/turf/open/floor/iron,
/area/station/engineering/supermatter/room)
"Wx" = (
/obj/machinery/power/emitter{
	dir = 1
	},
/obj/structure/cable,
/turf/open/floor/plating/airless,
/area/space/nearstation)
"WG" = (
/obj/structure/grille,
/obj/structure/grille,
/turf/open/space/basic,
/area/space/nearstation)
"WQ" = (
/obj/structure/sign/warning/radiation,
/turf/closed/wall/r_wall,
/area/station/maintenance/department/science/xenobiology)
"XE" = (
/obj/machinery/atmospherics/components/unary/vent_scrubber/on/layer2,
/obj/machinery/firealarm/directional/east,
/turf/open/floor/iron/dark,
/area/station/engineering/supermatter/room)
"Yl" = (
/obj/machinery/atmospherics/components/unary/vent_scrubber/on/layer2,
/turf/open/floor/iron,
/area/station/engineering/supermatter/room)
"Zy" = (
/obj/structure/cable/multilayer/connected,
/obj/effect/decal/cleanable/dirt,
/turf/open/floor/iron,
/area/station/engineering/supermatter/room)
"ZH" = (
/obj/effect/turf_decal/stripes/line{
	dir = 1
	},
/turf/open/floor/plating,
/area/station/engineering/supermatter/room)

(1,1,1) = {"
fG
fG
fG
fG
rp
rp
va
tt
va
tt
tt
tt
tt
WG
tt
tt
va
tt
va
rp
rp
fG
fG
"}
(2,1,1) = {"
fG
fG
fG
fG
rp
EZ
va
va
va
va
va
va
va
va
va
va
va
va
va
uV
rp
fG
fG
"}
(3,1,1) = {"
fG
fG
fG
fG
va
va
va
va
va
Vl
va
Vl
Vl
Rx
va
Vl
va
va
va
va
va
fG
fG
"}
(4,1,1) = {"
fG
fG
fG
fG
tt
va
oD
oD
cb
zl
Vl
cE
cE
cE
Vl
zl
Wx
oD
oD
va
tt
fG
fG
"}
(5,1,1) = {"
fG
fG
fG
fG
va
va
oD
va
va
Vl
EJ
Vl
cE
Vl
EJ
Vl
va
va
oD
va
va
fG
fG
"}
(6,1,1) = {"
fG
fG
fG
fG
rp
va
oD
va
up
Vl
Vl
cE
cE
cE
Vl
Vl
xG
va
oD
va
rp
fG
fG
"}
(7,1,1) = {"
fG
fG
fG
fG
tt
va
Bf
zn
TW
gH
cE
cE
EH
cE
cE
gH
TW
zn
Bf
va
Ve
fG
fG
"}
(8,1,1) = {"
fG
fG
fG
fG
va
va
Bf
va
xG
Vl
Vl
cE
cE
cE
Vl
Vl
up
va
Bf
va
cw
fG
fG
"}
(9,1,1) = {"
fG
fG
fG
fG
va
va
Bf
va
va
Vl
EJ
Vl
cE
Vl
EJ
Vl
va
va
Bf
va
va
fG
fG
"}
(10,1,1) = {"
fG
fG
fG
fG
rp
va
Bf
va
Vl
zl
Vl
cE
cE
cE
Vl
zl
Vl
va
Bf
va
tt
fG
fG
"}
(11,1,1) = {"
fG
fG
fG
fG
va
va
Bf
va
va
MU
va
Vl
Vl
Vl
va
MU
va
va
Bf
va
IQ
fG
fG
"}
(12,1,1) = {"
fG
fG
fG
fG
va
va
Bf
Bf
Bf
Bf
Bf
Bf
Bf
Bf
Bf
Bf
Bf
Bf
Bf
va
IQ
fG
fG
"}
(13,1,1) = {"
fG
fG
fG
fG
va
va
va
va
va
va
va
va
va
va
va
va
va
va
Bf
va
IQ
fG
fG
"}
(14,1,1) = {"
fG
fG
fG
fG
va
va
va
va
Vi
Rx
Rx
Rx
Rx
Rx
Rx
Rx
uA
va
Bf
va
IQ
fG
fG
"}
(15,1,1) = {"
fG
fG
fG
fG
lO
Ki
hD
Ki
lO
lO
Ki
Ki
Ki
Ki
Ki
lO
lO
Ki
uI
Ki
WQ
fG
fG
"}
(16,1,1) = {"
fG
fG
fG
fG
lO
PP
PP
Ri
lO
eD
vG
eD
eD
vG
eD
eD
lO
PP
Rz
Ri
IQ
fG
fG
"}
(17,1,1) = {"
lO
lO
Ki
lO
lO
Ki
Gq
Ki
lO
gR
vG
Es
gN
fW
eD
jK
lO
Ki
xM
Ki
IQ
fG
fG
"}
(18,1,1) = {"
lO
qo
uq
PQ
Ki
yt
yt
Wr
lO
vG
eD
ZH
BW
vg
eD
vG
lO
re
lq
gv
IQ
fG
fG
"}
(19,1,1) = {"
lO
aq
Vz
KI
Ki
yt
ze
yt
lO
eD
eD
DA
AD
vg
eD
vG
lO
Gj
pv
Zy
IQ
fG
fG
"}
(20,1,1) = {"
lO
Sg
Kf
KI
Ki
yt
yt
yt
lO
Mm
eD
im
KB
Bl
vG
aJ
lO
nr
DJ
Pv
IQ
fG
fG
"}
(21,1,1) = {"
lO
Sg
Kf
KI
Ki
yt
ze
yt
lO
eD
eD
XE
KK
nO
eD
eD
lO
yt
qV
bv
UX
fG
fG
"}
(22,1,1) = {"
lO
NF
NF
Aw
sm
xj
LQ
yt
lO
lO
Ki
lO
ku
lO
Ki
lO
lO
yt
qV
yt
be
fG
fG
"}
(23,1,1) = {"
lO
eC
eC
fa
Ki
yt
LQ
ze
yt
yt
yt
Ke
LQ
Lc
yt
QP
yt
yt
LQ
yt
UX
fG
fG
"}
(24,1,1) = {"
lO
Hm
Kf
Ez
lO
yt
LQ
qV
LQ
LQ
LQ
LQ
LQ
LQ
LQ
LQ
LQ
qV
LQ
pG
SV
fG
fG
"}
(25,1,1) = {"
lO
xR
HJ
jk
lO
yt
yt
ze
yt
hg
yt
xj
yt
yt
yt
yt
yt
ze
LQ
UC
SV
mv
fG
"}
(26,1,1) = {"
lO
lO
Ki
lO
lO
lO
Ki
Ki
lO
lO
yt
xj
ze
ze
ze
yt
ze
yt
lO
MF
pV
SV
SV
"}
(27,1,1) = {"
lO
VR
VR
VR
bl
bl
pT
eg
FS
Ki
yt
xj
yt
yt
yt
yt
yt
gC
Ki
Fj
Fj
aR
SV
"}
(28,1,1) = {"
lO
cd
cd
cd
rF
sA
iV
yt
yt
No
yt
xj
bv
yt
yt
ze
MA
ur
Ki
ze
AH
wo
SV
"}
(29,1,1) = {"
lO
Ae
yt
yt
yt
yt
mx
yt
ze
No
yt
xj
yt
yt
ze
yt
yt
zs
Ki
Yl
dy
cT
SV
"}
(30,1,1) = {"
lO
hk
hn
eD
eD
eD
eD
hn
bJ
xw
yt
QK
yt
xf
xN
fL
RG
yb
Ki
aA
fi
IY
SV
"}
(31,1,1) = {"
lO
ku
lO
Ki
lO
Ki
lO
lO
lO
lO
Ki
eJ
Ki
lO
lO
lO
lO
Ki
lO
lO
Ip
lO
SV
"}
